fier	fi:e:r|fj:E:R	1
grès	gr:ès:|gR:E:	1
grattent	gr:at:tent|gR:a:t	1
hile	:hi:le|:i:l	1
lionne	li:on:ne|lj:O:n	1
stick	st:i:ck|st:i:k	1
berce	b:e:rce|b:E:Rs	1
plisse	pl:i:sse|pl:i:s	1
gouttes	g:out:tes|g:u:t	1
vaste	v:a:ste|v:a:st	1
aïe	:aï:e|:a:j	1
croit	croi:t:|kRw:a:	1
huant	hu:ant:|8:@:	1
spruce	spr:u:ce|spR:y:s	1
salle	s:al:le|s:a:l	1
ventres	v:en:tres|v:@:tR	1
nèfles	n:è:fles|n:E:fl	1
frère	fr:è:re|fR:E:R	1
eûmes	:eû:mes|:y:m	1
birbe	b:i:rbe|b:i:Rb	1
flottes	fl:ot:tes|fl:O:t	1
raff	r:a:ff|R:a:f	1
liesse	li:e:sse|lj:E:s	1
dia	di:a:|dj:a:	1
cops	c:o:ps|k:O:p	1
chiches	ch:i:ches|S:i:S	1
fiance	fi:an:ce|fj:@:s	1
couine	cou:i:ne|kw:i:n	1
re	r:e:|R:2:	1
sonnes	s:on:nes|s:O:n	1
loués	lou:és:|lw:e:	1
casse	c:a:sse|k:a:s	1
stuc	st:u:c|st:y:k	1
tronche	tr:on:che|tR:§:S	1
grêlent	gr:ê:lent|gR:E:l	1
susse	s:u:sse|s:y:s	1
touffe	t:ou:ffe|t:u:f	1
canne	c:a:nne|k:a:n	1
roche	r:o:che|R:O:S	1
riment	r:i:ment|R:i:m	1
berg	b:e:rg|b:E:Rg	1
coudent	c:ou:dent|k:u:d	1
soeurs	so:eur:s|s:9:R	1
bouses	b:ou:ses|b:u:z	1
daim	d:aim:|d:5:	1
clips	cl:i:ps|kl:i:p	1
perle	p:e:rle|p:E:Rl	1
pâle	p:â:le|p:a:l	1
cangue	c:an:gue|k:@:g	1
glace	gl:a:ce|gl:a:s	1
sprints	spr:i:nts|spR:i:nt	1
gangues	g:an:gues|g:@:g	1
bec	b:e:c|b:E:k	1
plusse	pl:u:sse|pl:y:s	1
tilt	t:i:lt|t:i:lt	1
dabe	d:a:be|d:a:b	1
guinde	gu:in:de|g:5:d	1
roules	r:ou:les|R:u:l	1
niaises	ni:ai:ses|nj:E:z	1
oeufs	:oeufs:|:2:	1
rouage	rou:a:ge|Rw:a:Z	1
huilent	hu:i:lent|8:i:l	1
vamps	v:amp:s|v:@:p	1
mortes	m:o:rtes|m:O:Rt	1
pâte	p:â:te|p:a:t	1
heurs	:heur:s|:9:R	1
liasse	li:a:sse|lj:a:s	1
sylve	s:y:lve|s:i:lv	1
courge	c:ou:rge|k:u:RZ	1
gloses	gl:o:ses|gl:o:z	1
thaïe	th:a:ïe|t:a:j	1
mâchent	m:â:chent|m:a:S	1
vioque	vi:o:que|vj:O:k	1
creuses	cr:eu:ses|kR:2:z	1
carpes	c:a:rpes|k:a:Rp	1
teintes	te:in:tes|t:5:t	1
prune	pr:u:ne|pR:y:n	1
tous	t:ou:s|t:u:s	1
plombe	pl:om:be|pl:§:b	1
gy	g:y:|Z:i:	1
fouie	fou:ie:|fw:i:	1
fisc	f:i:sc|f:i:sk	1
liche	l:i:che|l:i:S	1
haches	:ha:ches|:a:S	1
liée	li:ée:|lj:e:	1
grise	gr:i:se|gR:i:z	1
taf	t:a:f|t:a:f	1
moelles	moe:l:les|mw:a:l	1
dût	d:ût:|d:y:	1
scope	sc:o:pe|sk:O:p	1
friches	fr:i:ches|fR:i:S	1
gnons	gn:ons:|N:§:	1
lacent	l:a:cent|l:a:s	1
schnouf	schn:ou:f|Sn:u:f	1
rimes	r:i:mes|R:i:m	1
pause	p:au:se|p:o:z	1
femmes	f:em:mes|f:a:m	1
guère	g:uè:re|g:E:R	1
cuisses	cu:i:sses|k8:i:s	1
housse	:hou:sse|:u:s	1
classe	cl:a:sse|kl:a:s	1
golfes	g:o:lfes|g:O:lf	1
bars	b:a:rs|b:a:R	1
jonques	j:on:ques|Z:§:k	1
chauffe	ch:au:ffe|S:o:f	1
spleens	spl:e:ens|spl:i:n	1
trucks	tr:u:cks|tR:y:k	1
campent	c:am:pent|k:@:p	1
plu	pl:u:|pl:y:	1
spring	spr:i:ng|spR:i:G	1
mère	m:è:re|m:E:R	1
psitt	ps:i:tt|ps:i:t	1
fonts	f:onts:|f:§:	1
i	:i:|:i:	1
frères	fr:è:res|fR:E:R	1
tût	t:ût:|t:y:	1
pâque	p:â:que|p:a:k	1
racles	r:a:cles|R:a:kl	1
ocre	:o:cre|:O:kR	1
grains	gr:ains:|gR:5:	1
vit	v:it:|v:i:	1
fronce	fr:on:ce|fR:§:s	1
bues	b:ues:|b:y:	1
à	:à:|:a:	1
cruche	cr:u:che|kR:y:S	1
brodes	br:o:des|bR:O:d	1
bruine	bru:i:ne|bR8:i:n	1
pool	po:o:l|p:u:l	1
hui	h:ui:|8:i:	1
krach	kr:a:ch|kR:a:k	1
dropent	dr:o:pent|dR:O:p	1
kirs	k:i:rs|k:i:R	1
chutent	ch:u:tent|S:y:t	1
bêtes	b:ê:tes|b:E:t	1
taies	t:aies:|t:E:	1
îles	:î:les|:i:l	1
hôte	:hô:te|:o:t	1
coups	cou:ps:|k:u:	1
vous	v:ous:|v:u:	1
nouage	nou:a:ge|nw:a:Z	1
vasques	v:a:sques|v:a:sk	1
nurse	n:u:rse|n:9:Rs	1
suède	su:è:de|s8:E:d	1
tonnes	t:on:nes|t:O:n	1
pris	pr:is:|pR:i:	1
gambe	g:am:be|g:@:b	1
pattes	p:at:tes|p:a:t	1
jarres	j:ar:res|Z:a:R	1
vals	v:a:ls|v:a:l	1
chiards	chi:a:rds|Sj:a:R	1
krachs	kr:a:chs|kR:a:k	1
peintres	pe:in:tres|p:5:tR	1
frappe	fr:a:ppe|fR:a:p	1
film	f:i:lm|f:i:lm	1
feuilles	f:eu:illes|f:9:j	1
droite	dro:i:te|dRw:a:t	1
fis	f:is:|f:i:	1
ceinte	ce:in:te|s:5:t	1
luxes	l:u:xes|l:y:ks	1
flirtent	fl:i:rtent|fl:9:Rt	1
thug	t:hu:g|t:y:g	1
frit	fr:it:|fR:i:	1
shah	s:hah:|S:a:	1
bocks	b:o:cks|b:O:k	1
tout	t:out:|t:u:	1
ranz	r:an:z|R:@:z	1
drinks	dr:in:ks|dR:5:k	1
créent	cr:éent:|kR:e:	1
tertres	t:e:rtres|t:E:RtR	1
vent	ve:nt:|v:@:	1
cap	c:a:p|k:a:p	1
goutte	g:ou:tte|g:u:t	1
gagnes	g:a:gnes|g:a:N	1
lobe	l:o:be|l:O:b	1
suit	sui:t:|s8:i:	1
lieuse	lie:u:se|lj:2:z	1
herse	:he:rse|:E:Rs	1
cueille	c:ue:ille|k:9:j	1
déc	d:é:c|d:e:k	1
fortes	f:o:rtes|f:O:Rt	1
chois	choi:s:|Sw:a:	1
fesses	f:e:sses|f:E:s	1
doublent	d:ou:blent|d:u:bl	1
trône	tr:ô:ne|tR:o:n	1
sût	s:ût:|s:y:	1
choix	choi:x:|Sw:a:	1
crête	cr:ê:te|kR:E:t	1
frondes	fr:on:des|fR:§:d	1
aie	:aie:|:E:	1
vifs	v:i:fs|v:i:f	1
perlent	p:e:rlent|p:E:Rl	1
jeep	je:e:p|dZ:i:p	1
bahts	b:a:hts|b:a:t	1
stress	str:e:ss|stR:E:s	1
doctes	d:o:ctes|d:O:kt	1
luttent	l:ut:tent|l:y:t	1
han	:han:|:@:	1
loups	lou:ps:|l:u:	1
quand	qu:and:|k:@:	1
thyrses	t:hy:rses|t:i:Rs	1
rapt	r:a:pt|R:a:pt	1
prismes	pr:i:smes|pR:i:zm	1
fentes	f:en:tes|f:@:t	1
rude	r:u:de|R:y:d	1
roc	r:o:c|R:O:k	1
membre	m:e:mbre|m:@:bR	1
baumes	b:au:mes|b:o:m	1
cul	c:ul:|k:y:	1
grognent	gr:o:gnent|gR:O:N	1
hall	:hal:l|:o:l	1
khmère	khm:è:re|km:E:R	1
fouette	fou:et:te|fw:E:t	1
phare	ph:a:re|f:a:R	1
cloc	cl:o:c|kl:O:k	1
pante	p:an:te|p:@:t	1
muer	mu:er:|m8:e:	1
fendent	f:en:dent|f:@:d	1
saoul	s:aoul:|s:u:	1
plaintes	pla:in:tes|pl:5:t	1
strie	str:ie:|stR:i:	1
halles	:hal:les|:a:l	1
craque	cr:a:que|kR:a:k	1
muse	m:u:se|m:y:z	1
basse	b:a:sse|b:a:s	1
toute	t:ou:te|t:u:t	1
tranche	tr:an:che|tR:@:S	1
chnoques	chn:o:ques|Sn:O:k	1
douanes	dou:a:nes|dw:a:n	1
baisent	b:ai:sent|b:E:z	1
roustes	r:ou:stes|R:u:st	1
bulls	b:ull:s|b:y:l	1
bobs	b:o:bs|b:O:b	1
youtre	y:ou:tre|j:u:tR	1
louves	l:ou:ves|l:u:v	1
zappes	z:a:ppes|z:a:p	1
soignent	so:i:gnent|sw:a:N	1
leste	l:e:ste|l:E:st	1
moche	m:o:che|m:O:S	1
shahs	s:hahs:|S:a:	1
liâmes	li:â:mes|lj:a:m	1
guerres	gu:er:res|g:E:R	1
jack	ja:c:k|dZ:a:k	1
sui	su:i:|s8:i:	1
coup	cou:p:|k:u:	1
craie	cr:aie:|kR:E:	1
flotte	fl:ot:te|fl:O:t	1
pot	p:ot:|p:o:	1
freak	fr:e:ak|fR:E:k	1
riel	ri:e:l|Rj:E:l	1
dey	d:ey:|d:E:	1
pouille	p:ou:ille|p:u:j	1
lestes	l:e:stes|l:E:st	1
bennes	b:en:nes|b:E:n	1
nautes	n:au:tes|n:o:t	1
truies	trui:es:|tR8:i:	1
aspre	:a:spre|:a:spR	1
rafe	r:a:fe|R:a:f	1
gai	g:ai:|g:E:	1
plaignes	pl:ai:gnes|pl:E:N	1
bé	b:é:|b:e:	1
sien	sie:n:|sj:5:	1
guides	gu:i:des|g:i:d	1
boîte	bo:î:te|bw:a:t	1
veut	ve:ut:|v:2:	1
ours	:ou:rs|:u:Rs	1
crosse	cr:o:sse|kR:O:s	1
bytes	b:y:tes|b:i:t	1
books	bo:o:ks|b:u:k	1
lèchent	l:è:chent|l:E:S	1
ceste	c:e:ste|s:E:st	1
nain	na:in:|n:5:	1
bloc	bl:o:c|bl:O:k	1
on	:on:|:§:	1
goth	g:oth:|g:o:	1
mettre	m:e:ttre|m:E:tR	1
geez	ge:e:z|dZ:i:z	1
chaîne	ch:aî:ne|S:E:n	1
grole	gr:o:le|gR:O:l	1
grègues	gr:è:gues|gR:E:g	1
villes	v:il:les|v:i:l	1
clapes	cl:a:pes|kl:a:p	1
cor	c:o:r|k:O:R	1
firent	f:i:rent|f:i:R	1
arbres	:a:rbres|:a:RbR	1
snacks	sn:a:cks|sn:a:k	1
firme	f:i:rme|f:i:Rm	1
plots	pl:ots:|pl:o:	1
kicks	k:i:cks|k:i:k	1
tau	t:au:|t:o:	1
feindre	f:e:indre|f:5:dR	1
tripe	tr:i:pe|tR:i:p	1
marge	m:a:rge|m:a:RZ	1
hêtre	:hê:tre|:E:tR	1
cèdre	c:è:dre|s:E:dR	1
doué	dou:é:|dw:e:	1
nippes	n:i:ppes|n:i:p	1
conques	c:on:ques|k:§:k	1
ouates	ou:a:tes|w:a:t	1
treize	tr:e:ize|tR:E:z	1
harpes	:ha:rpes|:a:Rp	1
plaide	pl:ai:de|pl:E:d	1
mythes	m:yth:es|m:i:t	1
sus	s:us:|s:y:	1
drogue	dr:o:gue|dR:O:g	1
calent	c:a:lent|k:a:l	1
chantent	ch:an:tent|S:@:t	1
sûrs	s:ûr:s|s:y:R	1
âme	:â:me|:a:m	1
juif	ju:i:f|Z8:i:f	1
rois	roi:s:|Rw:a:	1
duègne	du:è:gne|d8:E:N	1
cagne	c:a:gne|k:a:N	1
chair	ch:ai:r|S:E:R	1
cet	c:e:t|s:E:t	1
sikh	s:i:kh|s:i:k	1
hâtent	:hâ:tent|:a:t	1
vête	v:ê:te|v:E:t	1
souabe	sou:a:be|sw:a:b	1
roulent	r:ou:lent|R:u:l	1
beurre	b:eur:re|b:9:R	1
torve	t:o:rve|t:O:Rv	1
put	p:ut:|p:y:	1
masques	m:a:sques|m:a:sk	1
brunch	br:u:nch|bR:9:nS	1
ri	r:i:|R:i:	1
astre	:a:stre|:a:stR	1
baie	b:aie:|b:E:	1
arque	:a:rque|:a:Rk	1
niant	ni:ant:|nj:@:	1
pingre	p:in:gre|p:5:gR	1
suaire	su:ai:re|s8:E:R	1
champ	ch:amp:|S:@:	1
vile	v:i:le|v:i:l	1
carme	c:a:rme|k:a:Rm	1
crèmes	cr:è:mes|kR:E:m	1
quinze	qu:in:ze|k:5:z	1
puits	pui:ts:|p8:i:	1
suintent	su:in:tent|s8:5:t	1
tripes	tr:i:pes|tR:i:p	1
seiches	s:ei:ches|s:E:S	1
curve	c:u:rve|k:y:Rv	1
fioles	fi:o:les|fj:O:l	1
anse	:an:se|:@:s	1
cuir	cu:i:r|k8:i:R	1
gond	g:ond:|g:§:	1
nôtre	n:ô:tre|n:o:tR	1
look	lo:o:k|l:u:k	1
branle	br:an:le|bR:@:l	1
birbes	b:i:rbes|b:i:Rb	1
chèvres	ch:è:vres|S:E:vR	1
valse	v:a:lse|v:a:ls	1
toit	toi:t:|tw:a:	1
scrute	scr:u:te|skR:y:t	1
griment	gr:i:ment|gR:i:m	1
broute	br:ou:te|bR:u:t	1
frôlent	fr:ô:lent|fR:o:l	1
garces	g:a:rces|g:a:Rs	1
reich	r:e:ich|R:a:jS	1
rue	r:ue:|R:y:	1
flancs	fla:ncs:|fl:@:	1
rounds	r:ou:nds|R:u:nd	1
brait	br:ait:|bR:E:	1
ruent	r:uent:|R:y:	1
trichent	tr:i:chent|tR:i:S	1
casque	c:a:sque|k:a:sk	1
taxe	t:a:xe|t:a:ks	1
liant	li:ant:|lj:@:	1
fiers	fi:e:rs|fj:E:R	1
plaises	pl:ai:ses|pl:E:z	1
play	pla:y:|pl:E:	1
chaut	ch:aut:|S:o:	1
marres	m:ar:res|m:a:R	1
baffle	b:a:ffle|b:a:fl	1
turfs	t:u:rfs|t:y:Rf	1
zèle	z:è:le|z:E:l	1
cryptes	cr:y:ptes|kR:i:pt	1
pouilles	p:ou:illes|p:u:j	1
mâles	m:â:les|m:a:l	1
nef	n:e:f|n:E:f	1
feinte	fe:in:te|f:5:t	1
chiais	chi:ais:|Sj:E:	1
tracs	tr:a:cs|tR:a:k	1
mètre	m:è:tre|m:E:tR	1
phoques	ph:o:ques|f:O:k	1
eût	:eût:|:y:	1
cheikh	ch:e:ikh|S:E:k	1
dual	du:a:l|d8:a:l	1
crissent	cr:i:ssent|kR:i:s	1
trompe	tr:om:pe|tR:§:p	1
pièces	pièc:e:s|pj:E:s	1
huns	:huns:|:1:	1
jaffe	j:a:ffe|Z:a:f	1
ève	:è:ve|:E:v	1
dol	d:o:l|d:O:l	1
mêles	m:ê:les|m:E:l	1
tarde	t:a:rde|t:a:Rd	1
mixe	m:i:xe|m:i:ks	1
lit	l:it:|l:i:	1
grandes	gr:an:des|gR:@:d	1
rouste	r:ou:ste|R:u:st	1
chênes	ch:ê:nes|S:E:n	1
becte	b:e:cte|b:E:kt	1
plainte	pla:in:te|pl:5:t	1
fout	fou:t:|f:u:	1
trèfles	tr:è:fles|tR:E:fl	1
fiasques	fi:a:sques|fj:a:sk	1
vases	v:a:ses|v:a:z	1
sprint	spr:i:nt|spR:i:nt	1
nurses	n:u:rses|n:9:Rs	1
roy	ro:y:|Rw:a:	1
soies	soi:es:|sw:a:	1
bio	bi:o:|bj:o:	1
louées	lou:ées:|lw:e:	1
plaise	pl:ai:se|pl:E:z	1
leu	l:eu:|l:2:	1
coûtent	co:û:tent|k:u:t	1
donc	d:on:c|d:§:k	1
gaine	g:ai:ne|g:E:n	1
brouillent	br:ou:illent|bR:u:j	1
pompent	p:om:pent|p:§:p	1
couvres	c:ou:vres|k:u:vR	1
clan	cl:an:|kl:@:	1
trouve	tr:ou:ve|tR:u:v	1
greens	gr:e:ens|gR:i:n	1
grâce	gr:â:ce|gR:a:s	1
rift	r:i:ft|R:i:ft	1
piaulent	pi:au:lent|pj:o:l	1
ploc	pl:o:c|pl:O:k	1
soudent	s:ou:dent|s:u:d	1
foudres	f:ou:dres|f:u:dR	1
tînt	t:înt:|t:5:	1
larguent	l:a:rguent|l:a:Rg	1
pieuvre	pi:eu:vre|pj:9:vR	1
taffes	t:a:ffes|t:a:f	1
groom	gr:o:om|gR:u:m	1
tom	t:o:m|t:O:m	1
mail	m:a:il|m:E:jl	1
tores	t:o:res|t:O:R	1
pubs	p:u:bs|p:9:b	1
ivre	:i:vre|:i:vR	1
graissent	gr:ai:ssent|gR:E:s	1
plâtrent	pl:â:trent|pl:a:tR	1
biaises	bi:ai:ses|bj:E:z	1
louables	lou:a:bles|lw:a:bl	1
gomme	g:om:me|g:O:m	1
frai	fr:ai:|fR:E:	1
enflent	:en:flent|:@:fl	1
tringles	tr:in:gles|tR:5:gl	1
milles	m:il:les|m:i:l	1
cheik	ch:e:ik|S:E:k	1
guerre	gu:er:re|g:E:R	1
rêves	r:ê:ves|R:E:v	1
chouettes	chou:et:tes|Sw:E:t	1
nones	n:o:nes|n:O:n	1
jouai	jou:ai:|Zw:E:	1
perches	p:e:rches|p:E:RS	1
draine	dr:ai:ne|dR:E:n	1
ide	:i:de|:i:d	1
book	bo:o:k|b:u:k	1
panne	p:a:nne|p:a:n	1
saine	s:ai:ne|s:E:n	1
filtres	f:i:ltres|f:i:ltR	1
ria	ri:a:|Rj:a:	1
gins	gi:n:s|dZ:i:n	1
bloquent	bl:o:quent|bl:O:k	1
bât	b:ât:|b:a:	1
ho	:ho:|:o:	1
lunes	l:u:nes|l:y:n	1
veuille	v:eu:ille|v:9:j	1
pulls	p:ull:s|p:y:l	1
jaspe	j:a:spe|Z:a:sp	1
colle	co:l:le|k:O:l	1
rifle	r:i:fle|R:i:fl	1
cultes	c:u:ltes|k:y:lt	1
pêches	p:ê:ches|p:E:S	1
suites	su:i:tes|s8:i:t	1
joigne	jo:i:gne|Zw:a:N	1
rangs	ra:ngs:|R:@:	1
sternes	st:e:rnes|st:E:Rn	1
moches	m:o:ches|m:O:S	1
bol	b:o:l|b:O:l	1
jeûnes	j:eû:nes|Z:2:n	1
carne	c:a:rne|k:a:Rn	1
gobe	g:o:be|g:O:b	1
chougne	ch:ou:gne|S:u:N	1
jeeps	je:e:ps|dZ:i:p	1
vendent	v:en:dent|v:@:d	1
lier	lie:r:|lj:e:	1
niches	n:i:ches|n:i:S	1
vine	v:i:ne|v:i:n	1
bloque	bl:o:que|bl:O:k	1
tuées	tu:ées:|t8:e:	1
mets	m:ets:|m:E:	1
gifles	g:i:fles|Z:i:fl	1
boeufs	b:oeufs:|b:2:	1
fauches	f:au:ches|f:o:S	1
films	f:i:lms|f:i:lm	1
quiète	qui:è:te|kj:E:t	1
dive	d:i:ve|d:i:v	1
age	:a:ge|:a:Z	1
bise	b:i:se|b:i:z	1
barbent	b:a:rbent|b:a:Rb	1
cachent	c:a:chent|k:a:S	1
droppe	dr:o:ppe|dR:O:p	1
nouille	n:ou:ille|n:u:j	1
plantes	pl:an:tes|pl:@:t	1
gîte	g:î:te|Z:i:t	1
plie	pl:ie:|pl:i:	1
guinches	gu:in:ches|g:5:S	1
creusent	cr:eu:sent|kR:2:z	1
fume	f:u:me|f:y:m	1
rousse	r:ou:sse|R:u:s	1
lez	l:ez:|l:E:	1
membres	m:e:mbres|m:@:bR	1
penches	p:en:ches|p:@:S	1
rates	r:a:tes|R:a:t	1
moises	moi:s:es|mw:a:z	1
grogne	gr:o:gne|gR:O:N	1
places	pl:a:ces|pl:a:s	1
raine	r:ai:ne|R:E:n	1
fluide	flu:i:de|fl8:i:d	1
prêchent	pr:ê:chent|pR:E:S	1
lés	l:és:|l:e:	1
ses	s:es:|s:e:	1
hume	:hu:me|:y:m	1
drachme	dr:a:chme|dR:a:km	1
battes	b:at:tes|b:a:t	1
ranch	r:a:nch|R:@:nS	1
orbes	:o:rbes|:O:Rb	1
plouk	pl:ou:k|pl:u:k	1
suivent	su:i:vent|s8:i:v	1
bluffs	bl:uf:fs|bl:9:f	1
traite	tr:ai:te|tR:E:t	1
lare	l:a:re|l:a:R	1
dure	d:u:re|d:y:R	1
tuque	t:u:que|t:y:k	1
fouinent	fou:i:nent|fw:i:n	1
beugle	b:eu:gle|b:2:gl	1
veulent	v:eu:lent|v:9:l	1
tôles	t:ô:les|t:o:l	1
song	s:on:g|s:§:g	1
eurent	:eu:rent|:y:R	1
gorge	g:o:rge|g:O:RZ	1
dykes	dyk:e:s|d:i:k	1
foulque	f:ou:lque|f:u:lk	1
boire	bo:i:re|bw:a:R	1
douées	dou:ées:|dw:e:	1
lin	l:in:|l:5:	1
huches	:hu:ches|:y:S	1
gonzes	g:on:zes|g:§:z	1
carte	c:a:rte|k:a:Rt	1
punks	p:unk:s|p:1:k	1
jantes	j:an:tes|Z:@:t	1
khâgne	kh:â:gne|k:a:N	1
plâtre	pl:â:tre|pl:a:tR	1
halte	:ha:lte|:a:lt	1
frappent	fr:a:ppent|fR:a:p	1
rousses	r:ou:sses|R:u:s	1
saque	s:a:que|s:a:k	1
dix	d:i:x|d:i:s	1
ground	gr:o:und|gR:a:wnd	1
rouillent	r:ou:illent|R:u:j	1
foc	f:o:c|f:O:k	1
truc	tr:u:c|tR:y:k	1
naphte	n:a:phte|n:a:ft	1
murs	m:ur:s|m:y:R	1
toues	t:oues:|t:u:	1
crampe	cr:am:pe|kR:@:p	1
suce	s:u:ce|s:y:s	1
faîte	f:aî:te|f:E:t	1
niait	ni:ait:|nj:E:	1
yeux	y:eux:|j:2:	1
mai	m:ai:|m:E:	1
flatte	fla:t:te|fl:a:t	1
sortent	s:o:rtent|s:O:Rt	1
yards	y:a:rds|j:a:R	1
trissent	tr:i:ssent|tR:i:s	1
gris	gr:is:|gR:i:	1
têtes	t:ê:tes|t:E:t	1
plais	pl:ais:|pl:E:	1
boutres	b:ou:tres|b:u:tR	1
changes	ch:an:ges|S:@:Z	1
riait	ri:ait:|Rj:E:	1
claie	cl:aie:|kl:E:	1
lats	l:a:ts|l:a:ts	1
buffle	b:u:ffle|b:y:fl	1
hydne	:hy:dne|:i:dn	1
cortes	c:o:rtes|k:O:Rt	1
strass	str:a:ss|stR:a:s	1
stèle	st:è:le|st:E:l	1
guimpe	g:uim:pe|g:5:p	1
chaires	ch:ai:res|S:E:R	1
dit	d:it:|d:i:	1
grive	gr:i:ve|gR:i:v	1
perdre	p:e:rdre|p:E:RdR	1
vise	v:i:se|v:i:z	1
paires	p:ai:res|p:E:R	1
bim	b:i:m|b:i:m	1
lampent	l:am:pent|l:@:p	1
fifre	f:i:fre|f:i:fR	1
liane	li:a:ne|lj:a:n	1
aillent	:a:illent|:a:j	1
fui	fu:i:|f8:i:	1
chaud	ch:aud:|S:o:	1
schnouff	schn:ou:ff|Sn:u:f	1
trac	tr:a:c|tR:a:k	1
aies	:aies:|:E:	1
tain	t:ain:|t:5:	1
goûts	g:oûts:|g:u:	1
cou	c:ou:|k:u:	1
folk	f:o:lk|f:O:lk	1
pais	p:ais:|p:E:	1
bridges	br:i:dges|bR:i:dZ	1
runes	r:u:nes|R:y:n	1
blocks	bl:o:cks|bl:O:k	1
choute	ch:ou:te|S:u:t	1
hutte	:hut:te|:y:t	1
plot	pl:ot:|pl:o:	1
louable	lou:a:ble|lw:a:bl	1
man	m:an:|m:@:	1
vaches	v:a:ches|v:a:S	1
pues	p:ues:|p:y:	1
conte	c:on:te|k:§:t	1
rués	ru:és:|R8:e:	1
bluffes	bl:u:ffes|bl:9:f	1
truismes	tru:i:smes|tR8:i:zm	1
rieuse	rie:u:se|Rj:2:z	1
clown	cl:o:wn|kl:u:n	1
brailles	br:a:illes|bR:a:j	1
doivent	do:i:vent|dw:a:v	1
tuais	tu:ais:|t8:E:	1
raflent	r:a:flent|R:a:fl	1
sortes	s:o:rtes|s:O:Rt	1
zèles	z:è:les|z:E:l	1
rouvres	r:ou:vres|R:u:vR	1
blaze	bl:a:ze|bl:a:z	1
corde	c:o:rde|k:O:Rd	1
baux	b:aux:|b:o:	1
squash	squ:a:sh|skw:a:S	1
brande	br:an:de|bR:@:d	1
plaste	pl:a:ste|pl:a:st	1
past	p:a:st|p:a:st	1
sarde	s:a:rde|s:a:Rd	1
louve	l:ou:ve|l:u:v	1
desk	d:e:sk|d:E:sk	1
vivre	v:i:vre|v:i:vR	1
squames	squ:a:mes|skw:a:m	1
dopes	d:o:pes|d:O:p	1
cales	c:a:les|k:a:l	1
gène	g:è:ne|Z:E:n	1
omble	:o:mble|:§:bl	1
damnent	d:am:nent|d:a:n	1
gour	g:ou:r|g:u:R	1
sachent	s:a:chent|s:a:S	1
mons	m:on:s|m:§:s	1
cèle	c:è:le|s:E:l	1
pèse	p:è:se|p:E:z	1
râle	r:â:le|R:a:l	1
sterne	st:e:rne|st:E:Rn	1
humble	:hu:mble|:1:bl	1
gemme	ge:m:me|Z:E:m	1
ruées	ru:ées:|R8:e:	1
houilles	:hou:illes|:u:j	1
niaient	ni:aient:|nj:E:	1
peulh	p:eu:lh|p:2:l	1
jonchent	j:on:chent|Z:§:S	1
vienne	vi:en:ne|vj:E:n	1
cuirs	cu:i:rs|k8:i:R	1
pleure	pl:eu:re|pl:9:R	1
sangles	s:an:gles|s:@:gl	1
hit	:hi:t|:i:t	1
crotte	cr:ot:te|kR:O:t	1
douane	dou:a:ne|dw:a:n	1
chêne	ch:ê:ne|S:E:n	1
luge	l:u:ge|l:y:Z	1
bals	b:a:ls|b:a:l	1
spores	sp:o:res|sp:O:R	1
zut	z:u:t|z:y:t	1
rentrent	r:en:trent|R:@:tR	1
cillent	c:i:llent|s:i:j	1
guêpes	g:uê:pes|g:E:p	1
sombre	s:om:bre|s:§:bR	1
labre	l:a:bre|l:a:bR	1
grèbes	gr:è:bes|gR:E:b	1
vautre	v:au:tre|v:o:tR	1
serpe	s:e:rpe|s:E:Rp	1
elfe	:e:lfe|:E:lf	1
smash	sm:a:sh|sm:a:tS	1
bief	bi:e:f|bj:E:f	1
merle	m:e:rle|m:E:Rl	1
moult	m:ou:lt|m:u:lt	1
rogue	r:o:gue|R:O:g	1
vouent	v:ouent:|v:u:	1
clic	cl:i:c|kl:i:k	1
riantes	ri:an:tes|Rj:@:t	1
turne	t:u:rne|t:y:Rn	1
failles	f:a:illes|f:a:j	1
groin	groi:n:|gRw:5:	1
brèves	br:è:ves|bR:E:v	1
diam	di:a:m|dj:a:m	1
granges	gr:an:ges|gR:@:Z	1
gade	g:a:de|g:a:d	1
zelle	z:el:le|z:E:l	1
herbes	:he:rbes|:E:Rb	1
dots	d:o:ts|d:O:t	1
lettres	l:e:ttres|l:E:tR	1
boudes	b:ou:des|b:u:d	1
reste	r:e:ste|R:E:st	1
tél	t:é:l|t:E:l	1
basent	b:a:sent|b:a:z	1
rompre	r:om:pre|R:§:pR	1
messe	m:e:sse|m:E:s	1
serve	s:e:rve|s:E:Rv	1
toque	t:o:que|t:O:k	1
guets	g:uets:|g:E:	1
douve	d:ou:ve|d:u:v	1
rez	r:ez:|R:e:	1
peuvent	p:eu:vent|p:9:v	1
sèment	s:è:ment|s:E:m	1
croque	cr:o:que|kR:O:k	1
dîtes	d:î:tes|d:i:t	1
clam	cl:a:m|kl:a:m	1
reg	r:e:g|R:E:g	1
rets	r:ets:|R:E:	1
drailles	dr:a:illes|dR:a:j	1
darse	d:a:rse|d:a:Rs	1
porc	p:or:c|p:O:R	1
nay	n:ay:|n:E:	1
nappes	n:a:ppes|n:a:p	1
vouée	vou:ée:|vw:e:	1
pionne	pi:on:ne|pj:O:n	1
schtroumpfs	schtr:ou:mpfs|StR:u:mf	1
grille	gr:i:lle|gR:i:j	1
skeet	ske:e:t|sk:i:t	1
jeans	je:a:ns|dZ:i:ns	1
louent	l:ouent:|l:u:	1
sieur	si:eu:r|sj:9:R	1
treuil	tr:eu:il|tR:9:j	1
hait	:hait:|:E:	1
fang	f:an:g|f:@:g	1
colles	co:l:les|k:O:l	1
une	:u:ne|:y:n	1
single	s:in:gle|s:5:gl	1
velte	v:e:lte|v:E:lt	1
ages	:a:ges|:a:Z	1
morfle	m:o:rfle|m:O:Rfl	1
sconse	sc:on:se|sk:§:s	1
aigue	:ai:gue|:E:g	1
molles	m:ol:les|m:O:l	1
ligue	l:i:gue|l:i:g	1
tourte	t:ou:rte|t:u:Rt	1
plane	pl:a:ne|pl:a:n	1
mues	m:ues:|m:y:	1
mord	m:o:rd|m:O:R	1
show	s:how:|S:o:	1
dore	d:o:re|d:O:R	1
sol	s:o:l|s:O:l	1
spin	sp:i:n|sp:i:n	1
bâfres	b:â:fres|b:a:fR	1
masse	m:a:sse|m:a:s	1
pissent	p:i:ssent|p:i:s	1
rare	r:a:re|R:a:R	1
guêpe	g:uê:pe|g:E:p	1
brusquent	br:u:squent|bR:y:sk	1
twist	tw:i:st|tw:i:st	1
kan	k:a:n|k:a:n	1
snif	sn:i:f|sn:i:f	1
juive	ju:i:ve|Z8:i:v	1
reis	r:e:is|R:E:js	1
frotte	fr:ot:te|fR:O:t	1
phrases	phr:a:ses|fR:a:z	1
bronzes	br:on:zes|bR:§:z	1
sans	s:ans:|s:@:	1
mîmes	m:î:mes|m:i:m	1
table	t:a:ble|t:a:bl	1
nouaient	nou:aient:|nw:E:	1
jugent	j:u:gent|Z:y:Z	1
talle	t:al:le|t:a:l	1
veau	ve:au:|v:o:	1
stries	str:ies:|stR:i:	1
montrent	m:on:trent|m:§:tR	1
ardre	:a:rdre|:a:RdR	1
legs	l:e:gs|l:E:g	1
sur	s:u:r|s:y:R	1
pies	p:ies:|p:i:	1
marre	m:ar:re|m:a:R	1
bûmes	b:û:mes|b:y:m	1
sain	s:ain:|s:5:	1
parlent	p:a:rlent|p:a:Rl	1
branque	br:an:que|bR:@:k	1
fard	f:a:rd|f:a:R	1
bière	bi:è:re|bj:E:R	1
dansent	d:an:sent|d:@:s	1
ciels	ci:e:ls|sj:E:l	1
rompt	ro:mpt:|R:§:	1
siffle	s:i:ffle|s:i:fl	1
fouille	f:ou:ille|f:u:j	1
moud	mo:ud:|m:u:	1
autres	:au:tres|:o:tR	1
sacres	s:a:cres|s:a:kR	1
piète	pi:è:te|pj:E:t	1
flaires	fl:ai:res|fl:E:R	1
biais	bi:ais:|bj:E:	1
teck	t:e:ck|t:E:k	1
côtes	c:ô:tes|k:o:t	1
pouffes	p:ou:ffes|p:u:f	1
rough	r:ou:gh|R:u:f	1
vaille	v:a:ille|v:a:j	1
coin	coi:n:|kw:5:	1
filme	f:i:lme|f:i:lm	1
dettes	d:et:tes|d:E:t	1
aires	:ai:res|:E:R	1
taux	t:aux:|t:o:	1
monts	mo:nts:|m:§:	1
couennes	cou:en:nes|kw:a:n	1
smurf	sm:u:rf|sm:9:Rf	1
brille	br:i:lle|bR:i:j	1
tonde	t:on:de|t:§:d	1
risquent	r:i:squent|R:i:sk	1
zoomes	zo:o:mes|z:u:m	1
go	g:o:|g:o:	1
slow	sl:ow:|sl:o:	1
pût	p:ût:|p:y:	1
poulpe	p:ou:lpe|p:u:lp	1
perche	p:e:rche|p:E:RS	1
stable	st:a:ble|st:a:bl	1
graves	gr:a:ves|gR:a:v	1
perdent	p:e:rdent|p:E:Rd	1
fugue	f:u:gue|f:y:g	1
race	r:a:ce|R:a:s	1
strophe	str:o:phe|stR:O:f	1
content	c:on:tent|k:§:t	1
chtibe	cht:i:be|St:i:b	1
score	sc:o:re|sk:O:R	1
fiefs	fi:e:fs|fj:E:f	1
bais	b:ais:|b:E:	1
carre	c:ar:re|k:a:R	1
urnes	:u:rnes|:y:Rn	1
christ	chr:i:st|kR:i:st	1
ive	:i:ve|:i:v	1
lues	l:ues:|l:y:	1
zyeutes	zye:u:tes|zj:2:t	1
navres	n:a:vres|n:a:vR	1
sciures	sci:u:res|sj:y:R	1
yachts	yach:t:s|j:O:t	1
flânent	fl:â:nent|fl:a:n	1
scheik	sch:e:ik|S:E:k	1
pauvres	p:au:vres|p:o:vR	1
dupe	d:u:pe|d:y:p	1
triche	tr:i:che|tR:i:S	1
benne	b:en:ne|b:E:n	1
moire	mo:i:re|mw:a:R	1
psys	ps:ys:|ps:i:	1
hampe	:ham:pe|:@:p	1
toue	t:oue:|t:u:	1
tulles	t:ul:les|t:y:l	1
meut	m:eut:|m:2:	1
êtes	:ê:tes|:E:t	1
père	p:è:re|p:E:R	1
fanent	f:a:nent|f:a:n	1
vue	v:ue:|v:y:	1
bouffent	b:ou:ffent|b:u:f	1
vexe	v:e:xe|v:E:ks	1
rossent	r:o:ssent|R:O:s	1
hantent	:han:tent|:@:t	1
pal	p:a:l|p:a:l	1
siam	si:a:m|sj:a:m	1
plinthe	pl:in:the|pl:5:t	1
bof	b:o:f|b:O:f	1
camp	c:amp:|k:@:	1
forent	f:o:rent|f:O:R	1
schnocks	schn:o:cks|Sn:O:k	1
jour	j:ou:r|Z:u:R	1
piles	p:i:les|p:i:l	1
mat	m:a:t|m:a:t	1
feins	f:eins:|f:5:	1
miles	m:i:les|m:a:jls	1
en	:en:|:@:	1
chromes	chr:o:mes|kR:o:m	1
charmes	ch:a:rmes|S:a:Rm	1
thune	t:hu:ne|t:y:n	1
stat	st:a:t|st:a:t	1
tondent	t:on:dent|t:§:d	1
poque	p:o:que|p:O:k	1
ouïe	ouï:e:|w:i:	1
vus	v:us:|v:y:	1
mourre	m:our:re|m:u:R	1
lionnes	li:on:nes|lj:O:n	1
dans	d:ans:|d:@:	1
khat	kh:a:t|k:a:t	1
smashe	sm:a:she|sm:a:tS	1
vraies	vr:aies:|vR:E:	1
juchent	j:u:chent|Z:y:S	1
cimes	c:i:mes|s:i:m	1
flask	fl:a:sk|fl:a:sk	1
creuse	cr:eu:se|kR:2:z	1
strict	str:i:ct|stR:i:kt	1
pence	p:e:nce|p:E:ns	1
liais	li:ais:|lj:E:	1
brocs	br:ocs:|bR:o:	1
piaillent	pi:a:illent|pj:a:j	1
flirt	fl:i:rt|fl:9:Rt	1
blaise	bl:ai:se|bl:E:z	1
schèmes	sch:è:mes|S:E:m	1
rouble	r:ou:ble|R:u:bl	1
gatte	ga:t:te|g:E:t	1
planquent	pl:an:quent|pl:@:k	1
bagnes	b:a:gnes|b:a:N	1
gloire	glo:i:re|glw:a:R	1
trop	tr:op:|tR:o:	1
jus	j:us:|Z:y:	1
matches	m:a:tches|m:a:tS	1
piètres	pi:è:tres|pj:E:tR	1
souple	s:ou:ple|s:u:pl	1
fientes	fie:n:tes|fj:@:t	1
dièse	di:è:se|dj:E:z	1
touques	t:ou:ques|t:u:k	1
scia	sci:a:|sj:a:	1
longues	l:on:gues|l:§:g	1
hardes	:ha:rdes|:a:Rd	1
flammes	fla:m:mes|fl:a:m	1
torves	t:o:rves|t:O:Rv	1
oignes	o:i:gnes|w:a:N	1
reine	r:e:ine|R:E:n	1
lettre	l:e:ttre|l:E:tR	1
chiale	chi:a:le|Sj:a:l	1
rase	r:a:se|R:a:z	1
mioches	mi:o:ches|mj:O:S	1
fats	f:a:ts|f:a:t	1
comtes	co:m:tes|k:§:t	1
aille	:a:ille|:a:j	1
love	l:o:ve|l:O:v	1
teigne	t:e:igne|t:E:N	1
boxent	b:o:xent|b:O:ks	1
val	v:a:l|v:a:l	1
mieux	mie:ux:|mj:2:	1
bac	b:a:c|b:a:k	1
nymphe	n:ymph:e|n:5:f	1
ciel	ci:e:l|sj:E:l	1
paon	p:aon:|p:@:	1
sorbes	s:o:rbes|s:O:Rb	1
fends	f:ends:|f:@:	1
peur	p:eu:r|p:2:R	1
bourses	b:ou:rses|b:u:Rs	1
orne	:o:rne|:O:Rn	1
jars	j:a:rs|Z:a:R	1
poudrent	p:ou:drent|p:u:dR	1
gammes	g:am:mes|g:a:m	1
pope	p:o:pe|p:O:p	1
nomme	no:m:me|n:O:m	1
monstres	m:on:stres|m:§:stR	1
ket	k:e:t|k:E:t	1
viande	vi:an:de|vj:@:d	1
gêne	g:ê:ne|Z:E:n	1
grecs	gr:e:cs|gR:E:k	1
nefs	n:e:fs|n:E:f	1
sphère	sph:è:re|sf:E:R	1
tâche	t:â:che|t:a:S	1
fore	f:o:re|f:O:R	1
surfes	s:u:rfes|s:9:Rf	1
scores	sc:o:res|sk:O:R	1
sbire	sb:i:re|sb:i:R	1
pôles	p:ô:les|p:o:l	1
lac	l:a:c|l:a:k	1
nichent	n:i:chent|n:i:S	1
steaks	st:e:aks|st:E:k	1
pousses	p:ou:sses|p:u:s	1
tordent	t:o:rdent|t:O:Rd	1
banc	b:anc:|b:@:	1
fusses	f:u:sses|f:y:s	1
tait	t:ait:|t:E:	1
miment	m:i:ment|m:i:m	1
marc	m:a:rc|m:a:R	1
dianes	di:a:nes|dj:a:n	1
miette	mie:t:te|mj:E:t	1
peignent	p:e:ignent|p:E:N	1
thrill	thr:i:ll|tR:i:l	1
ganses	g:an:ses|g:@:s	1
boulle	b:ou:lle|b:u:l	1
dus	d:us:|d:y:	1
ange	:an:ge|:@:Z	1
plomb	pl:omb:|pl:§:	1
cool	co:o:l|k:u:l	1
souabes	sou:a:bes|sw:a:b	1
flèches	fl:è:ches|fl:E:S	1
sourdes	s:ou:rdes|s:u:Rd	1
cause	c:au:se|k:o:z	1
dissent	d:i:ssent|d:i:s	1
jeûne	j:eû:ne|Z:2:n	1
fils	f:i:ls|f:i:s	1
propres	pr:o:pres|pR:O:pR	1
proche	pr:o:che|pR:O:S	1
crânes	cr:â:nes|kR:a:n	1
pouce	p:ou:ce|p:u:s	1
heur	:heu:r|:9:R	1
fagne	f:a:gne|f:a:N	1
liguent	l:i:guent|l:i:g	1
payent	p:ay:ent|p:e:j	1
courte	c:ou:rte|k:u:Rt	1
rente	r:en:te|R:@:t	1
ointes	o:in:tes|w:5:t	1
spath	sp:a:th|sp:a:t	1
croûte	cr:oû:te|kR:u:t	1
dribbles	dr:i:bbles|dR:i:bl	1
calf	c:a:lf|k:a:lf	1
piaffent	pi:a:ffent|pj:a:f	1
fiaient	fi:aient:|fj:E:	1
liez	lie:z:|lj:e:	1
nouai	nou:ai:|nw:E:	1
oeuvre	:oe:uvre|:9:vR	1
mangent	m:an:gent|m:@:Z	1
puisque	pu:i:sque|p8:i:sk	1
lerche	l:e:rche|l:E:RS	1
chaudes	ch:au:des|S:o:d	1
penses	p:en:ses|p:@:s	1
montent	m:on:tent|m:§:t	1
chtar	cht:a:r|St:a:R	1
baissent	b:ai:ssent|b:E:s	1
strient	str:ient:|stR:i:	1
clappe	cl:a:ppe|kl:a:p	1
graphe	gr:a:phe|gR:a:f	1
isthmes	:i:sthmes|:i:zm	1
braques	br:a:ques|bR:a:k	1
digues	d:i:gues|d:i:g	1
shunte	s:hun:te|S:1:t	1
myopes	my:o:pes|mj:O:p	1
muscles	m:u:scles|m:y:skl	1
scène	s:cè:ne|s:E:n	1
store	st:o:re|st:O:R	1
hures	:hu:res|:y:R	1
jacques	j:ac:ques|Z:a:k	1
kil	k:i:l|k:i:l	1
indes	:in:des|:5:d	1
boucle	b:ou:cle|b:u:kl	1
cherche	ch:e:rche|S:E:RS	1
plaindre	pla:in:dre|pl:5:dR	1
que	qu:e:|k:2:	1
sent	s:ent:|s:@:	1
cercles	c:e:rcles|s:E:Rkl	1
poire	po:i:re|pw:a:R	1
jouasses	jou:a:sses|Zw:a:s	1
goitre	go:i:tre|gw:a:tR	1
jures	j:u:res|Z:y:R	1
aine	:ai:ne|:E:n	1
note	n:o:te|n:O:t	1
suantes	su:an:tes|s8:@:t	1
nouer	nou:er:|nw:e:	1
muettes	mu:et:tes|m8:E:t	1
sculpte	sc:u:lpte|sk:y:lt	1
tees	t:ees:|t:i:	1
bales	b:a:les|b:a:l	1
laides	l:ai:des|l:E:d	1
va	v:a:|v:a:	1
crosnes	cr:o:snes|kR:O:sn	1
hampes	:ham:pes|:@:p	1
heurtent	:heu:rtent|:9:Rt	1
lion	li:on:|lj:§:	1
sciées	sci:ées:|sj:e:	1
stups	st:u:ps|st:y:p	1
croches	cr:o:ches|kR:O:S	1
ocres	:o:cres|:O:kR	1
tic	t:i:c|t:i:k	1
cosses	c:o:sses|k:O:s	1
frondent	fr:on:dent|fR:§:d	1
lions	li:ons:|lj:§:	1
soûl	s:oûl:|s:u:	1
saules	s:au:les|s:o:l	1
plaids	pl:ai:ds|pl:E:d	1
te	t:e:|t:2:	1
slips	sl:i:ps|sl:i:p	1
sub	s:u:b|s:y:b	1
câble	c:â:ble|k:a:bl	1
merdre	m:e:rdre|m:E:RdR	1
dictes	d:i:ctes|d:i:kt	1
nuée	nu:ée:|n8:e:	1
quart	qu:a:rt|k:a:R	1
glose	gl:o:se|gl:o:z	1
las	l:as:|l:a:	1
sperme	sp:e:rme|sp:E:Rm	1
tort	t:or:t|t:O:R	1
plumes	pl:u:mes|pl:y:m	1
group	gr:ou:p|gR:u:p	1
fraîche	fr:aî:che|fR:E:S	1
vampe	v:am:pe|v:@:p	1
cène	c:è:ne|s:E:n	1
mués	mu:és:|m8:e:	1
crypte	cr:y:pte|kR:i:pt	1
brume	br:u:me|bR:y:m	1
prin	pr:in:|pR:5:	1
tec	t:e:c|t:E:k	1
boy	b:o:y|b:O:j	1
brin	br:in:|bR:5:	1
tir	t:i:r|t:i:R	1
puy	pu:y:|p8:i:	1
jointes	jo:in:tes|Zw:5:t	1
prennes	pr:en:nes|pR:E:n	1
mous	m:ous:|m:u:	1
doutes	d:ou:tes|d:u:t	1
soc	s:o:c|s:O:k	1
pelles	p:el:les|p:E:l	1
dinguent	d:in:guent|d:5:g	1
chôment	ch:ô:ment|S:o:m	1
tops	t:o:ps|t:O:p	1
chauves	ch:au:ves|S:o:v	1
souhaites	sou:hai:tes|sw:E:t	1
hymne	:hy:mne|:i:mn	1
braillent	br:a:illent|bR:a:j	1
lift	l:i:ft|l:i:ft	1
paumes	p:au:mes|p:o:m	1
cament	c:a:ment|k:a:m	1
gronde	gr:on:de|gR:§:d	1
pie	p:ie:|p:i:	1
pieuse	pie:u:se|pj:2:z	1
trogne	tr:o:gne|tR:O:N	1
fruste	fr:u:ste|fR:y:st	1
sonnent	s:on:nent|s:O:n	1
singes	s:in:ges|s:5:Z	1
grouillent	gr:ou:illent|gR:u:j	1
bades	b:a:des|b:a:d	1
piges	p:i:ges|p:i:Z	1
servent	s:e:rvent|s:E:Rv	1
pries	pr:ies:|pR:i:	1
roues	r:oues:|R:u:	1
vaillent	v:a:illent|v:a:j	1
raies	r:aies:|R:E:	1
squaw	squa:w:|skw:o:	1
laine	l:ai:ne|l:E:n	1
dom	d:om:|d:§:	1
phlox	phl:o:x|fl:O:ks	1
gâchent	g:â:chent|g:a:S	1
tanches	t:an:ches|t:@:S	1
viocque	vi:oc:que|vj:O:k	1
mièvre	mi:è:vre|mj:E:vR	1
jouais	jou:ais:|Zw:E:	1
coins	coi:ns:|kw:5:	1
scripts	scr:i:pts|skR:i:pt	1
saoule	sa:ou:le|s:u:l	1
baye	b:a:ye|b:a:j	1
ounce	:o:unce|:a:wns	1
sorts	s:o:rts|s:O:R	1
colt	c:o:lt|k:O:lt	1
noient	noi:ent:|nw:a:	1
voue	v:oue:|v:u:	1
banne	b:a:nne|b:a:n	1
pli	pl:i:|pl:i:	1
feuj	f:eu:j|f:2:Z	1
laines	l:ai:nes|l:E:n	1
rotent	r:o:tent|R:O:t	1
doge	d:o:ge|d:O:Z	1
taie	t:aie:|t:E:	1
cône	c:ô:ne|k:o:n	1
lynchent	l:yn:chent|l:5:S	1
gourme	g:ou:rme|g:u:Rm	1
quêtent	qu:ê:tent|k:E:t	1
trament	tr:a:ment|tR:a:m	1
quartz	qu:a:rtz|kw:a:Rts	1
please	pl:e:ase|pl:i:z	1
nan	n:an:|n:@:	1
jute	j:u:te|Z:y:t	1
flop	fl:o:p|fl:O:p	1
calme	c:a:lme|k:a:lm	1
khmer	khm:e:r|km:E:R	1
sacque	s:ac:que|s:a:k	1
ville	v:il:le|v:i:l	1
chiottes	chi:ot:tes|Sj:O:t	1
rhume	r:hu:me|R:y:m	1
calmes	c:a:lmes|k:a:lm	1
puants	pu:ants:|p8:@:	1
vesces	v:es:ces|v:E:s	1
plongent	pl:on:gent|pl:§:Z	1
osent	:o:sent|:o:z	1
griffes	gr:i:ffes|gR:i:f	1
dents	d:ents:|d:@:	1
couds	cou:ds:|k:u:	1
sarclent	s:a:rclent|s:a:Rkl	1
bull	b:ul:l|b:y:l	1
bai	b:ai:|b:E:	1
peuples	p:eu:ples|p:9:pl	1
parcs	p:a:rcs|p:a:Rk	1
corsent	c:o:rsent|k:O:Rs	1
fâchent	f:â:chent|f:a:S	1
grêle	gr:ê:le|gR:E:l	1
gnard	gn:a:rd|N:a:R	1
poile	po:i:le|pw:a:l	1
dont	d:ont:|d:§:	1
quels	qu:e:ls|k:E:l	1
carres	c:ar:res|k:a:R	1
sets	s:e:ts|s:E:t	1
seins	s:eins:|s:5:	1
ouah	ou:ah:|w:a:	1
bagues	b:a:gues|b:a:g	1
drôle	dr:ô:le|dR:o:l	1
leurre	l:eur:re|l:9:R	1
sas	s:as:|s:a:	1
braies	br:aies:|bR:E:	1
louaient	lou:aient:|lw:E:	1
tourne	t:ou:rne|t:u:Rn	1
ouvres	:ou:vres|:u:vR	1
kits	k:i:ts|k:i:t	1
tri	tr:i:|tR:i:	1
down	d:o:wn|d:a:wn	1
slang	sl:an:g|sl:@:g	1
bossent	b:o:ssent|b:O:s	1
brise	br:i:se|bR:i:z	1
briffe	br:i:ffe|bR:i:f	1
chum	ch:u:m|S:u:m	1
loche	l:o:che|l:O:S	1
laps	l:a:ps|l:a:ps	1
vêts	v:êts:|v:E:	1
barrent	b:ar:rent|b:a:R	1
merde	m:e:rde|m:E:Rd	1
raids	r:ai:ds|R:E:d	1
dingues	d:in:gues|d:5:g	1
art	:ar:t|:a:R	1
roux	rou:x:|R:u:	1
chintz	ch:i:ntz|S:i:nts	1
balles	b:al:les|b:a:l	1
muche	m:u:che|m:y:S	1
fluxe	fl:u:xe|fl:y:ks	1
cintre	c:in:tre|s:5:tR	1
gant	g:ant:|g:@:	1
naît	n:aît:|n:E:	1
taisent	t:ai:sent|t:E:z	1
dignes	d:i:gnes|d:i:N	1
libres	l:i:bres|l:i:bR	1
blinde	bl:in:de|bl:5:d	1
gang	g:an:g|g:@:g	1
meurs	m:eur:s|m:9:R	1
pige	p:i:ge|p:i:Z	1
fions	fi:ons:|fj:§:	1
sèmes	s:è:mes|s:E:m	1
schbeb	schb:e:b|Sb:°:b	1
vogue	v:o:gue|v:O:g	1
rêches	r:ê:ches|R:E:S	1
purge	p:u:rge|p:y:RZ	1
faste	f:a:ste|f:a:st	1
drachmes	dr:a:chmes|dR:a:km	1
sobres	s:o:bres|s:O:bR	1
grouse	gr:ou:se|gR:u:z	1
mussent	m:u:ssent|m:y:s	1
rît	r:ît:|R:i:	1
drain	dr:ain:|dR:5:	1
temps	t:emps:|t:@:	1
jusqu	j:u:squ|Z:y:sk	1
rouaient	rou:aient:|Rw:E:	1
double	d:ou:ble|d:u:bl	1
tige	t:i:ge|t:i:Z	1
tasses	t:a:sses|t:a:s	1
spore	sp:o:re|sp:O:R	1
le	l:e:|l:2:	1
paye	p:a:ye|p:E:j	1
grilles	gr:i:lles|gR:i:j	1
bougne	b:ou:gne|b:u:N	1
surfent	s:u:rfent|s:9:Rf	1
lui	lu:i:|l8:i:	1
chouans	chou:ans:|Sw:@:	1
cabrent	c:a:brent|k:a:bR	1
chiles	ch:i:les|S:i:l	1
vaque	v:a:que|v:a:k	1
ivres	:i:vres|:i:vR	1
bordes	b:o:rdes|b:O:Rd	1
grolles	gr:ol:les|gR:O:l	1
oeil	:oe:il|:9:j	1
broque	br:o:que|bR:O:k	1
môles	m:ô:les|m:o:l	1
bâillent	b:â:illent|b:a:j	1
moulent	m:ou:lent|m:u:l	1
scare	sc:a:re|sk:a:R	1
jonglent	j:on:glent|Z:§:gl	1
stones	st:o:nes|st:o:n	1
clape	cl:a:pe|kl:a:p	1
lots	l:ots:|l:o:	1
skiez	skie:z:|skj:e:	1
vouge	v:ou:ge|v:u:Z	1
mou	m:ou:|m:u:	1
yu	y:u:|j:y:	1
donnent	do:n:nent|d:O:n	1
tramp	tr:am:p|tR:@:p	1
joués	jou:és:|Zw:e:	1
stables	st:a:bles|st:a:bl	1
blases	bl:a:ses|bl:a:z	1
merdes	m:e:rdes|m:E:Rd	1
dioptre	di:o:ptre|dj:O:ptR	1
ove	:o:ve|:O:v	1
damne	d:am:ne|d:a:n	1
feints	f:eints:|f:5:	1
squires	squ:i:res|skw:a:jR	1
broutes	br:ou:tes|bR:u:t	1
cadrent	c:a:drent|k:a:dR	1
traques	tr:a:ques|tR:a:k	1
plombent	pl:ombe:nt|pl:§:b	1
huîtres	hu:î:tres|8:i:tR	1
tiennes	ti:en:nes|tj:E:n	1
derches	d:e:rches|d:E:RS	1
seuil	s:eu:il|s:9:j	1
auge	:au:ge|:o:Z	1
tracent	tr:a:cent|tR:a:s	1
hontes	:hon:tes|:§:t	1
loutres	l:ou:tres|l:u:tR	1
vins	v:ins:|v:5:	1
âne	:â:ne|:a:n	1
boivent	bo:i:vent|bw:a:v	1
squat	squ:a:t|skw:a:t	1
transes	tr:an:ses|tR:@:s	1
cake	c:ak:e|k:E:k	1
peins	p:eins:|p:5:	1
pères	p:è:res|p:E:R	1
drapent	dr:a:pent|dR:a:p	1
cornes	c:o:rnes|k:O:Rn	1
bourdes	b:ou:rdes|b:u:Rd	1
cluse	cl:u:se|kl:y:z	1
strates	str:a:tes|stR:a:t	1
croupes	cr:ou:pes|kR:u:p	1
mouette	mou:et:te|mw:E:t	1
feulent	f:eu:lent|f:9:l	1
nulle	n:ul:le|n:y:l	1
vainc	va:in:c|v:5:k	1
tourtes	t:ou:rtes|t:u:Rt	1
stals	st:a:ls|st:a:l	1
house	:h:ouse|:a:wz	1
thés	t:hés:|t:e:	1
becs	b:e:cs|b:E:k	1
vend	v:end:|v:@:	1
daubes	d:au:bes|d:o:b	1
piot	pi:ot:|pj:o:	1
ventes	v:en:tes|v:@:t	1
chaule	ch:au:le|S:o:l	1
veinent	ve:i:nent|v:E:n	1
forces	f:o:rces|f:O:Rs	1
zest	z:e:st|z:E:st	1
tinte	t:in:te|t:5:t	1
visse	v:i:sse|v:i:s	1
patte	p:at:te|p:a:t	1
chambres	ch:a:mbres|S:@:bR	1
xiang	xia:n:g|gzj:@:g	1
cheap	ch:e:ap|tS:i:p	1
moins	moi:ns:|mw:5:	1
règnent	r:è:gnent|R:E:N	1
mènes	m:è:nes|m:E:n	1
où	:où:|:u:	1
triques	tr:i:ques|tR:i:k	1
celte	c:e:lte|s:E:lt	1
ourse	:ou:rse|:u:Rs	1
jeu	j:eu:|Z:2:	1
riaient	ri:aient:|Rj:E:	1
ouille	:ou:ille|:u:j	1
privent	pr:i:vent|pR:i:v	1
ka	k:a:|k:a:	1
kurde	k:u:rde|k:y:Rd	1
ferment	f:e:rment|f:E:Rm	1
ronge	r:on:ge|R:§:Z	1
larve	l:a:rve|l:a:Rv	1
pieuses	pie:u:ses|pj:2:z	1
coiffe	coi:f:fe|kw:a:f	1
vents	ve:nts:|v:@:	1
culte	c:u:lte|k:y:lt	1
dieu	die:u:|dj:2:	1
crin	cr:in:|kR:5:	1
tsars	ts:a:rs|ts:a:R	1
glandent	gl:an:dent|gl:@:d	1
chance	ch:an:ce|S:@:s	1
seringues	ser:in:gues|sR:5:g	1
points	poi:nts:|pw:5:	1
venges	v:en:ges|v:@:Z	1
sprats	spr:a:ts|spR:a:t	1
fiez	fie:z:|fj:e:	1
sauce	s:au:ce|s:o:s	1
ronfles	r:on:fles|R:§:fl	1
natte	na:t:te|n:a:t	1
frets	fr:ets:|fR:E:	1
moques	m:o:ques|m:O:k	1
cottes	co:t:tes|k:O:t	1
trimes	tr:i:mes|tR:i:m	1
chique	ch:i:que|S:i:k	1
happe	:hap:pe|:a:p	1
ruât	ru:ât:|R8:a:	1
tempe	t:em:pe|t:@:p	1
coud	cou:d:|k:u:	1
rab	r:a:b|R:a:b	1
sals	s:a:ls|s:a:l	1
gâtent	g:â:tent|g:a:t	1
vergue	v:e:rgue|v:E:Rg	1
chauve	ch:au:ve|S:o:v	1
doc	d:o:c|d:O:k	1
mat'	m:a:t'|m:a:t	1
glyphe	gl:y:phe|gl:i:f	1
bâcles	b:â:cles|b:a:kl	1
claquent	cl:a:quent|kl:a:k	1
guiche	gu:i:che|g:i:S	1
dis	d:is:|d:i:	1
huart	hu:a:rt|8:a:R	1
trolle	tr:ol:le|tR:O:l	1
bintje	b:i:ntje|b:i:ntS	1
nord	n:o:rd|n:O:R	1
pine	p:i:ne|p:i:n	1
ouiche	ou:i:che|w:i:S	1
brefs	br:e:fs|bR:E:f	1
choppes	ch:op:pes|S:O:p	1
braise	br:ai:se|bR:E:z	1
vouèrent	vou:è:rent|vw:E:R	1
fesse	f:e:sse|f:E:s	1
bus	b:u:s|b:y:s	1
souffles	s:ou:ffles|s:u:fl	1
kirsch	ki:r:sch|k:i:RS	1
frime	fr:i:me|fR:i:m	1
hun	:hun:|:1:	1
tanguent	t:an:guent|t:@:g	1
broum	br:ou:m|bR:u:m	1
scient	s:cient:|s:i:	1
fourre	f:our:re|f:u:R	1
triples	tr:i:ples|tR:i:pl	1
faînes	f:aî:nes|f:E:n	1
brûles	br:û:les|bR:y:l	1
terme	t:e:rme|t:E:Rm	1
steeples	st:e:eples|st:i:pl	1
carnes	c:a:rnes|k:a:Rn	1
causse	c:au:sse|k:o:s	1
perm	p:e:rm|p:E:Rm	1
veules	v:eu:les|v:2:l	1
clams	cl:a:ms|kl:a:m	1
vibrent	v:i:brent|v:i:bR	1
prouvent	pr:ou:vent|pR:u:v	1
douces	d:ou:ces|d:u:s	1
louèrent	lou:è:rent|lw:E:R	1
marbre	m:a:rbre|m:a:RbR	1
moi	mo:i:|mw:a:	1
louai	lou:ai:|lw:E:	1
castes	c:a:stes|k:a:st	1
lack	l:a:ck|l:a:k	1
coûtes	co:û:tes|k:u:t	1
hordes	:ho:rdes|:O:Rd	1
pantes	p:an:tes|p:@:t	1
p.	p:.:|p:e:	1
fibres	f:i:bres|f:i:bR	1
soûls	s:oûls:|s:u:	1
tentent	t:en:tent|t:@:t	1
reins	re:ins:|R:5:	1
queues	que:ues:|k:2:	1
zip	z:i:p|z:i:p	1
hissent	:hi:ssent|:i:s	1
tueur	tu:eu:r|t8:9:R	1
mouchent	m:ou:chent|m:u:S	1
bolge	b:o:lge|b:O:lZ	1
souks	s:ou:ks|s:u:k	1
môme	m:ô:me|m:o:m	1
tiges	t:i:ges|t:i:Z	1
coite	co:i:te|kw:a:t	1
dan	d:a:n|d:a:n	1
perdes	p:e:rdes|p:E:Rd	1
dard	d:a:rd|d:a:R	1
goy	g:o:y|g:O:j	1
celle	c:el:le|s:E:l	1
brament	br:a:ment|bR:a:m	1
grève	gr:è:ve|gR:E:v	1
bath	b:a:th|b:a:t	1
butent	b:u:tent|b:y:t	1
antre	:an:tre|:@:tR	1
pierres	pi:er:res|pj:E:R	1
skinhead	skinh:e:ad|skj:E:d	1
vite	v:i:te|v:i:t	1
scier	scie:r:|sj:e:	1
nuances	nu:an:ces|n8:@:s	1
boueuses	bou:eu:ses|bw:2:z	1
rongent	r:on:gent|R:§:Z	1
cabre	c:a:bre|k:a:bR	1
fiacre	fi:a:cre|fj:a:kR	1
figent	f:i:gent|f:i:Z	1
dagues	d:a:gues|d:a:g	1
rot	r:ot:|R:o:	1
live	l:i:ve|l:i:v	1
fraudes	fr:au:des|fR:o:d	1
jointe	jo:in:te|Zw:5:t	1
drop	dr:o:p|dR:O:p	1
huait	hu:ait:|8:E:	1
frayes	fr:ay:es|fR:e:j	1
match	m:a:tch|m:a:tS	1
pisse	p:i:sse|p:i:s	1
me	m:e:|m:2:	1
calte	c:a:lte|k:a:lt	1
lieus	lie:us:|lj:2:	1
lucre	l:u:cre|l:y:kR	1
plans	pla:ns:|pl:@:	1
grogs	gr:o:gs|gR:O:g	1
elles	:el:les|:E:l	1
quille	q:u:ille|k:i:j	1
misent	m:i:sent|m:i:z	1
viles	v:i:les|v:i:l	1
vante	v:an:te|v:@:t	1
é	:é:|:e:	1
cieux	cie:ux:|sj:2:	1
don	d:on:|d:§:	1
ras	ra:s:|R:a:	1
guet	g:uet:|g:E:	1
venge	v:en:ge|v:@:Z	1
classes	cl:a:sses|kl:a:s	1
grèbe	gr:è:be|gR:E:b	1
chante	ch:an:te|S:@:t	1
hadj	:ha:dj|:a:dZ	1
pane	p:a:ne|p:a:n	1
seing	s:eing:|s:5:	1
toast	t:o:ast|t:o:st	1
vouer	vou:er:|vw:e:	1
shootes	sho:o:tes|S:u:t	1
mange	m:an:ge|m:@:Z	1
choquent	ch:o:quent|S:O:k	1
mis	m:is:|m:i:	1
riante	ri:an:te|Rj:@:t	1
bleu	bl:eu:|bl:2:	1
farce	f:a:rce|f:a:Rs	1
dupent	d:u:pent|d:y:p	1
jeunes	j:eu:nes|Z:9:n	1
cens	c:en:s|s:@:s	1
vinssent	v:in:ssent|v:5:s	1
crime	cr:i:me|kR:i:m	1
pompes	p:om:pes|p:§:p	1
toss	t:o:ss|t:O:s	1
chiques	ch:i:ques|S:i:k	1
yard	y:a:rd|j:a:R	1
toise	toi:s:e|tw:a:z	1
touffes	t:ou:ffes|t:u:f	1
pare	p:a:re|p:a:R	1
trappes	tr:a:ppes|tR:a:p	1
rustres	r:u:stres|R:y:stR	1
navre	n:a:vre|n:a:vR	1
groins	groi:ns:|gRw:5:	1
hymnes	:hy:mnes|:i:mn	1
bâche	b:â:che|b:a:S	1
brasse	br:a:sse|bR:a:s	1
chef	ch:e:f|S:E:f	1
doués	dou:és:|dw:e:	1
larmes	l:a:rmes|l:a:Rm	1
meules	m:eu:les|m:2:l	1
noces	n:o:ces|n:O:s	1
stressent	str:e:ssent|stR:E:s	1
junte	j:un:te|Z:1:t	1
ruant	ru:ant:|R8:@:	1
biglent	b:i:glent|b:i:gl	1
ben	b:en:|b:5:	1
zyeute	zye:u:te|zj:2:t	1
harde	:ha:rde|:a:Rd	1
chlass	chl:a:ss|Sl:a:s	1
sente	s:en:te|s:@:t	1
fins	f:ins:|f:5:	1
virent	v:i:rent|v:i:R	1
secte	s:e:cte|s:E:kt	1
pilent	p:i:lent|p:i:l	1
trine	tr:i:ne|tR:i:n	1
corses	c:o:rses|k:O:Rs	1
flouse	fl:ou:se|fl:u:z	1
meuble	m:eu:ble|m:9:bl	1
sixte	s:i:xte|s:i:kst	1
huître	hu:î:tre|8:i:tR	1
pier	pi:e:r|pj:E:R	1
douillent	d:ou:illent|d:u:j	1
grincent	gr:inc:ent|gR:5:s	1
dors	d:or:s|d:O:R	1
chient	ch:ient:|S:i:	1
passent	p:a:ssent|p:a:s	1
chèque	ch:è:que|S:E:k	1
tire	t:i:re|t:i:R	1
vives	v:i:ves|v:i:v	1
joua	jou:a:|Zw:a:	1
ranges	r:an:ges|R:@:Z	1
sec	s:e:c|s:E:k	1
schnaps	schn:a:ps|Sn:a:ps	1
mûre	m:û:re|m:y:R	1
dalles	d:al:les|d:a:l	1
quelle	que:l:le|k:E:l	1
fuirent	fu:i:rent|f8:i:R	1
gags	g:a:gs|g:a:g	1
çà	ç:à:|s:a:	1
sapes	s:a:pes|s:a:p	1
faxes	f:a:xes|f:a:ks	1
mûres	m:û:res|m:y:R	1
joui	jou:i:|Zw:i:	1
folles	f:ol:les|f:O:l	1
sape	s:a:pe|s:a:p	1
brunchs	br:u:nchs|bR:9:nS	1
tuée	tu:ée:|t8:e:	1
glotte	gl:ot:te|gl:O:t	1
gain	g:ain:|g:5:	1
plant	pla:nt:|pl:@:	1
iambe	i:am:be|j:@:b	1
douelle	dou:el:le|dw:E:l	1
fusent	f:u:sent|f:y:z	1
stops	st:o:ps|st:O:p	1
grande	gr:an:de|gR:@:d	1
flanques	fl:an:ques|fl:@:k	1
steeple	st:e:eple|st:i:pl	1
souhaitent	sou:hai:tent|sw:E:t	1
druides	dru:i:des|dR8:i:d	1
croître	cro:î:tre|kRw:a:tR	1
jouèrent	jou:è:rent|Zw:E:R	1
suât	su:ât:|s8:a:	1
boulent	b:ou:lent|b:u:l	1
drues	dr:ues:|dR:y:	1
choie	choi:e:|Sw:a:	1
loupent	l:ou:pent|l:u:p	1
eue	:eue:|:y:	1
thaï	th:a:ï|t:a:j	1
dame	d:a:me|d:a:m	1
crêpe	cr:ê:pe|kR:E:p	1
denses	d:en:ses|d:@:s	1
amples	:am:ples|:@:pl	1
ixe	:i:xe|:i:ks	1
loua	lou:a:|lw:a:	1
muai	mu:ai:|m8:E:	1
nards	n:a:rds|n:a:R	1
entre	:en:tre|:@:tR	1
chers	ch:e:rs|S:E:R	1
pluche	pl:u:che|pl:y:S	1
lis	li:s:|l:i:	1
donnes	do:n:nes|d:O:n	1
nap	n:a:p|n:a:p	1
gels	g:e:ls|Z:E:l	1
ponds	p:onds:|p:§:	1
bourrent	b:our:rent|b:u:R	1
réf	r:é:f|R:e:f	1
couenne	cou:en:ne|kw:a:n	1
barres	b:ar:res|b:a:R	1
jusques	j:u:sques|Z:y:sk	1
fris	fr:is:|fR:i:	1
fraude	fr:au:de|fR:o:d	1
bulge	b:u:lge|b:9:ldZ	1
juives	ju:i:ves|Z8:i:v	1
votent	v:o:tent|v:O:t	1
slip	sl:i:p|sl:i:p	1
louais	lou:ais:|lw:E:	1
mites	m:i:tes|m:i:t	1
nib	n:i:b|n:i:b	1
prouts	pr:ou:ts|pR:u:t	1
saignent	s:ai:gnent|s:E:N	1
faille	f:a:ille|f:a:j	1
sorte	s:o:rte|s:O:Rt	1
sues	s:ues:|s:y:	1
nids	n:ids:|n:i:	1
vergues	v:e:rgues|v:E:Rg	1
vache	v:a:che|v:a:S	1
jouons	jou:ons:|Zw:§:	1
cages	c:a:ges|k:a:Z	1
saute	s:au:te|s:o:t	1
bau	b:au:|b:o:	1
croques	cr:o:ques|kR:O:k	1
fourche	f:ou:rche|f:u:RS	1
coaches	c:o:aches|k:o:tS	1
tour	t:ou:r|t:u:R	1
blazes	bl:a:zes|bl:a:z	1
lange	l:an:ge|l:@:Z	1
bourg	b:ou:rg|b:u:R	1
gaze	g:a:ze|g:a:z	1
puantes	pu:an:tes|p8:@:t	1
foules	f:ou:les|f:u:l	1
diacre	di:a:cre|dj:a:kR	1
kriss	kr:i:ss|kR:i:s	1
cuis	cui:s:|k8:i:	1
raquent	r:a:quent|R:a:k	1
ploient	ploi:ent:|plw:a:	1
vieilles	vi:e:illes|vj:E:j	1
faute	f:au:te|f:o:t	1
douar	dou:a:r|dw:a:R	1
sourde	s:ou:rde|s:u:Rd	1
lourds	l:ou:rds|l:u:R	1
grouille	gr:ou:ille|gR:u:j	1
bauge	b:au:ge|b:o:Z	1
gnous	gn:ous:|gn:u:	1
coupes	c:ou:pes|k:u:p	1
rouille	r:ou:ille|R:u:j	1
gènes	g:è:nes|Z:E:n	1
verbe	v:e:rbe|v:E:Rb	1
timbre	t:i:mbre|t:5:bR	1
trottent	tr:ot:tent|tR:O:t	1
strictes	str:i:ctes|stR:i:kt	1
trilles	tr:i:lles|tR:i:j	1
bue	b:ue:|b:y:	1
scalps	sc:a:lps|sk:a:lp	1
doubles	d:ou:bles|d:u:bl	1
jattes	ja:t:tes|Z:a:t	1
land	l:an:d|l:@:d	1
ape	:a:pe|:a:p	1
pouah	pou:ah:|pw:a:	1
veuves	v:eu:ves|v:9:v	1
fèves	f:è:ves|f:E:v	1
homes	:ho:mes|:o:m	1
chapes	ch:a:pes|S:a:p	1
droites	dro:i:tes|dRw:a:t	1
manne	m:a:nne|m:a:n	1
vis	vi:s:|v:i:	1
lient	l:ient:|l:i:	1
u	:u:|:y:	1
casses	c:a:sses|k:a:s	1
gogues	g:o:gues|g:O:g	1
lance	l:an:ce|l:@:s	1
soutes	s:ou:tes|s:u:t	1
scies	s:cies:|s:i:	1
ter	t:e:r|t:E:R	1
stipes	st:i:pes|st:i:p	1
fou	f:ou:|f:u:	1
rogues	r:o:gues|R:O:g	1
fissent	f:i:ssent|f:i:s	1
hais	:hais:|:E:	1
pisses	p:i:sses|p:i:s	1
clones	cl:o:nes|kl:o:n	1
bob	b:o:b|b:O:b	1
un	:un:|:1:	1
care	c:a:re|k:a:R	1
douelles	dou:el:les|dw:E:l	1
ale	:a:le|:a:l	1
ombles	:o:mbles|:§:bl	1
cinglent	c:in:glent|s:5:gl	1
gicles	g:i:cles|Z:i:kl	1
cloques	cl:o:ques|kl:O:k	1
crient	cr:ient:|kR:i:	1
tilts	t:i:lts|t:i:lt	1
chiures	chi:u:res|Sj:y:R	1
sûmes	s:û:mes|s:y:m	1
flattes	fla:t:tes|fl:a:t	1
doges	d:o:ges|d:O:Z	1
rives	r:i:ves|R:i:v	1
vaux	v:aux:|v:o:	1
douait	dou:ait:|dw:E:	1
tuantes	tu:an:tes|t8:@:t	1
mâche	m:â:che|m:a:S	1
sangle	s:an:gle|s:@:gl	1
bonze	b:on:ze|b:§:z	1
flirtes	fl:i:rtes|fl:9:Rt	1
zieutes	zie:u:tes|zj:2:t	1
tais	t:ais:|t:E:	1
gongs	g:on:gs|g:§:g	1
plient	pl:ient:|pl:i:	1
myrtes	m:y:rtes|m:i:Rt	1
rais	r:ais:|R:E:	1
spectre	sp:e:ctre|sp:E:ktR	1
rentres	r:en:tres|R:@:tR	1
longue	l:on:gue|l:§:g	1
crasses	cr:a:sses|kR:a:s	1
chienne	chi:en:ne|Sj:E:n	1
glanent	gl:a:nent|gl:a:n	1
peaux	p:eaux:|p:o:	1
parent	p:a:rent|p:a:R	1
dronte	dr:on:te|dR:§:t	1
près	pr:ès:|pR:E:	1
tris	tr:is:|tR:i:	1
faunes	f:au:nes|f:o:n	1
briques	br:i:ques|bR:i:k	1
boeuf	bo:eu:f|b:9:f	1
nouée	nou:ée:|nw:e:	1
houle	:hou:le|:u:l	1
prient	pr:ient:|pR:i:	1
sel	s:e:l|s:E:l	1
crique	cr:i:que|kR:i:k	1
blets	bl:ets:|bl:E:	1
sbires	sb:i:res|sb:i:R	1
nulles	n:ul:les|n:y:l	1
cokes	co:k:es|k:o:k	1
bord	b:o:rd|b:O:R	1
nuer	nu:er:|n8:e:	1
chais	ch:ais:|S:E:	1
clapent	cl:a:pent|kl:a:p	1
fus	f:us:|f:y:	1
sobre	s:o:bre|s:O:bR	1
durent	d:u:rent|d:y:R	1
douée	dou:ée:|dw:e:	1
vôtres	v:ô:tres|v:o:tR	1
brêles	br:ê:les|bR:E:l	1
beau	b:eau:|b:o:	1
perchent	p:e:rchent|p:E:RS	1
vapes	v:a:pes|v:a:p	1
meures	m:eu:res|m:9:R	1
fait	f:ait:|f:E:	1
torchent	t:o:rchent|t:O:RS	1
stucs	st:u:cs|st:y:k	1
tel	t:e:l|t:E:l	1
bêle	b:ê:le|b:E:l	1
blues	bl:u:es|bl:u:z	1
stands	st:an:ds|st:@:d	1
lur	l:u:r|l:u:R	1
sifflent	s:i:fflent|s:i:fl	1
morse	m:o:rse|m:O:Rs	1
puzzles	p:u:zzles|p:9:zl	1
moque	m:o:que|m:O:k	1
rails	r:a:ils|R:a:j	1
naisses	n:ai:sses|n:E:s	1
gnon	gn:on:|N:§:	1
dragues	dr:a:gues|dR:a:g	1
pure	p:u:re|p:y:R	1
casquent	c:a:squent|k:a:sk	1
turc	t:u:rc|t:y:Rk	1
point	poi:nt:|pw:5:	1
douilles	d:ou:illes|d:u:j	1
piques	p:i:ques|p:i:k	1
douille	d:ou:ille|d:u:j	1
rex	r:e:x|R:E:ks	1
ceux	c:eux:|s:2:	1
croient	croi:ent:|kRw:a:	1
stade	st:a:de|st:a:d	1
soins	soi:ns:|sw:5:	1
daims	d:aims:|d:5:	1
doigts	doi:gts:|dw:a:	1
vos	v:os:|v:o:	1
greffe	gr:e:ffe|gR:E:f	1
ruaient	ru:aient:|R8:E:	1
nave	n:a:ve|n:a:v	1
nonce	n:on:ce|n:§:s	1
jappe	j:a:ppe|Z:a:p	1
ronds	r:onds:|R:§:	1
let	l:et:|l:E:	1
friment	fr:i:ment|fR:i:m	1
rampent	r:am:pent|R:@:p	1
rognent	r:o:gnent|R:O:N	1
clac	cl:a:c|kl:a:k	1
gi	g:i:|Z:i:	1
coffrent	c:o:ffrent|k:O:fR	1
prends	pr:ends:|pR:@:	1
fougue	f:ou:gue|f:u:g	1
roui	rou:i:|Rw:i:	1
hommes	:hom:mes|:O:m	1
sang	s:ang:|s:@:	1
li	l:i:|l:i:	1
voient	voi:ent:|vw:a:	1
hale	:ha:le|:a:l	1
chrome	chr:o:me|kR:o:m	1
chasse	ch:a:sse|S:a:s	1
sèches	s:è:ches|s:E:S	1
vols	v:o:ls|v:O:l	1
cas	c:as:|k:a:	1
pompe	p:om:pe|p:§:p	1
loues	lou:es:|l:u:	1
fermes	f:e:rmes|f:E:Rm	1
crispent	cr:i:spent|kR:i:sp	1
muées	mu:ées:|m8:e:	1
grec	gr:e:c|gR:E:k	1
chargent	ch:a:rgent|S:a:RZ	1
flâne	fl:â:ne|fl:a:n	1
prof	pr:o:f|pR:O:f	1
plâtres	pl:â:tres|pl:a:tR	1
skié	ski:é:|skj:e:	1
mailles	m:a:illes|m:a:j	1
bistres	b:i:stres|b:i:stR	1
tél.	t:é:l.|t:e:l	1
cherres	ch:er:res|S:E:R	1
bulles	b:ul:les|b:y:l	1
port	p:or:t|p:O:R	1
mixtes	m:i:xtes|m:i:kst	1
cycle	c:y:cle|s:i:kl	1
dite	d:i:te|d:i:t	1
fouet	fou:et:|fw:E:	1
viole	vi:o:le|vj:O:l	1
planches	pl:an:ches|pl:@:S	1
gourent	g:ou:rent|g:u:R	1
nouait	nou:ait:|nw:E:	1
brigue	br:i:gue|bR:i:g	1
cosse	c:o:sse|k:O:s	1
huer	hu:er:|8:e:	1
filment	f:i:lment|f:i:lm	1
puante	pu:an:te|p8:@:t	1
nymphes	n:ymphe:s|n:5:f	1
cigle	c:i:gle|s:i:gl	1
putt	p:ut:t|p:9:t	1
pêche	p:ê:che|p:E:S	1
cyan	cy:an:|sj:@:	1
rien	rie:n:|Rj:5:	1
flics	fl:i:cs|fl:i:k	1
fente	f:en:te|f:@:t	1
ruches	r:u:ches|R:y:S	1
gig	g:i:g|Z:i:g	1
sciais	sci:ais:|sj:E:	1
boume	b:ou:me|b:u:m	1
ouh	:ouh:|:u:	1
brick	br:i:ck|bR:i:k	1
masses	m:a:sses|m:a:s	1
lest	l:e:st|l:E:st	1
pschent	psch:e:nt|psS:E:nt	1
lacs	l:a:cs|l:a:k	1
fiait	fi:ait:|fj:E:	1
boers	b:oer:s|b:e:R	1
stup	st:u:p|st:y:p	1
frites	fr:i:tes|fR:i:t	1
orme	:o:rme|:O:Rm	1
choure	ch:ou:re|S:u:R	1
pèche	p:è:che|p:E:S	1
quick	qu:i:ck|k:i:k	1
glas	gla:s:|gl:a:	1
trotte	tr:ot:te|tR:O:t	1
spic	sp:i:c|sp:i:k	1
souque	s:ou:que|s:u:k	1
galbes	g:a:lbes|g:a:lb	1
tailles	t:a:illes|t:a:j	1
flashes	fla:s:hes|fl:a:S	1
fric	fr:i:c|fR:i:k	1
grau	gr:au:|gR:o:	1
fouines	fou:i:nes|fw:i:n	1
loch	l:o:ch|l:O:k	1
fuite	fu:i:te|f8:i:t	1
trille	tr:i:lle|tR:i:j	1
rend	r:end:|R:@:	1
nuage	nu:a:ge|n8:a:Z	1
skunks	sk:unk:s|sk:§:s	1
lièges	li:è:ges|lj:E:Z	1
pin's	p:i:n's|p:i:ns	1
bègues	b:è:gues|b:E:g	1
suante	su:an:te|s8:@:t	1
lait	l:ait:|l:E:	1
skient	sk:ient:|sk:i:	1
groles	gr:o:les|gR:O:l	1
moelle	moe:l:le|mw:a:l	1
guide	gu:i:de|g:i:d	1
fauche	f:au:che|f:o:S	1
aste	:a:ste|:a:st	1
christs	chr:i:sts|kR:i:st	1
ber	b:e:r|b:9:R	1
gaupe	g:au:pe|g:o:p	1
queue	que:ue:|k:2:	1
joutes	j:ou:tes|Z:u:t	1
caste	c:a:ste|k:a:st	1
ut	:u:t|:y:t	1
sales	s:a:les|s:a:l	1
parquent	p:a:rquent|p:a:Rk	1
voile	vo:i:le|vw:a:l	1
bêche	b:ê:che|b:E:S	1
docks	d:o:cks|d:O:k	1
plut	pl:ut:|pl:y:	1
tard	t:a:rd|t:a:R	1
noue	n:oue:|n:u:	1
volts	v:o:lts|v:O:lt	1
meuf	m:eu:f|m:9:f	1
dards	d:a:rds|d:a:R	1
vie	v:ie:|v:i:	1
piffre	p:i:ffre|p:i:fR	1
choutes	ch:ou:tes|S:u:t	1
speedes	spe:e:des|sp:i:d	1
fines	f:i:nes|f:i:n	1
bain	b:ain:|b:5:	1
pistent	p:i:stent|p:i:st	1
dromes	dr:o:mes|dR:o:m	1
ère	:è:re|:E:R	1
saches	s:a:ches|s:a:S	1
vôtre	v:ô:tre|v:o:tR	1
choient	choi:ent:|Sw:a:	1
yourte	y:ou:rte|j:u:Rt	1
bordent	b:o:rdent|b:O:Rd	1
arment	:a:rment|:a:Rm	1
fouissent	fou:i:ssent|fw:i:s	1
keums	k:eu:ms|k:2:m	1
fra	fr:a:|fR:a:	1
schlitte	schl:it:te|Sl:i:t	1
baffes	b:a:ffes|b:a:f	1
cru	cr:u:|kR:y:	1
braye	br:a:ye|bR:E:j	1
der	d:e:r|d:E:R	1
rushes	r:us:hes|R:9:S	1
aises	:ai:ses|:E:z	1
var	v:a:r|v:a:R	1
djinns	dj:i:nns|dZ:i:n	1
braire	br:ai:re|bR:E:R	1
bronchent	br:on:chent|bR:§:S	1
suivre	su:i:vre|s8:i:vR	1
brousse	br:ou:sse|bR:u:s	1
bougent	b:ou:gent|b:u:Z	1
teint	t:eint:|t:5:	1
bronzent	br:on:zent|bR:§:z	1
squale	squ:a:le|skw:a:l	1
feule	f:eu:le|f:9:l	1
cueillent	c:ue:illent|k:9:j	1
chine	ch:i:ne|S:i:n	1
lerch	l:e:rch|l:E:RS	1
jouir	jou:i:r|Zw:i:R	1
balte	b:a:lte|b:a:lt	1
brette	br:et:te|bR:E:t	1
craindre	cra:in:dre|kR:5:dR	1
moines	mo:i:nes|mw:a:n	1
cric	cr:i:c|kR:i:k	1
chi	c:hi:|k:i:	1
grège	gr:è:ge|gR:E:Z	1
cruches	cr:u:ches|kR:y:S	1
bougnes	b:ou:gnes|b:u:N	1
mains	ma:ins:|m:5:	1
mire	m:i:re|m:i:R	1
gable	g:a:ble|g:a:bl	1
foui	fou:i:|fw:i:	1
clebs	cl:e:bs|kl:E:ps	1
douchent	d:ou:chent|d:u:S	1
bond	b:ond:|b:§:	1
trèfle	tr:è:fle|tR:E:fl	1
baigne	b:ai:gne|b:E:N	1
toasts	t:oa:sts|t:o:st	1
sire	s:i:re|s:i:R	1
dises	d:i:ses|d:i:z	1
miam	mi:a:m|mj:a:m	1
zincs	z:in:cs|z:5:g	1
chiites	chi:i:tes|Sj:i:t	1
gage	g:a:ge|g:a:Z	1
faf	f:a:f|f:a:f	1
pousse	p:ou:sse|p:u:s	1
gendres	g:en:dres|Z:@:dR	1
bing	b:i:ng|b:i:G	1
doche	d:o:che|d:O:S	1
trolls	tr:o:lls|tR:O:l	1
rasse	r:a:sse|R:a:s	1
gut	g:u:t|g:y:t	1
lorgnent	l:o:rgnent|l:O:RN	1
lève	l:è:ve|l:E:v	1
nim	n:i:m|n:i:m	1
vioques	vi:o:ques|vj:O:k	1
greffes	gr:e:ffes|gR:E:f	1
gavent	g:a:vent|g:a:v	1
niez	nie:z:|nj:e:	1
mauve	m:au:ve|m:o:v	1
grecque	gre:c:que|gR:E:k	1
trouvent	tr:ou:vent|tR:u:v	1
forme	f:o:rme|f:O:Rm	1
pouls	p:ouls:|p:u:	1
seront	ser:ont:|sR:§:	1
bloom	bl:o:om|bl:u:m	1
breuils	br:eu:ils|bR:9:j	1
boive	bo:i:ve|bw:a:v	1
djinn	dj:i:nn|dZ:i:n	1
souilles	s:ou:illes|s:u:j	1
blancs	bla:ncs:|bl:@:	1
harts	:hart:s|:a:R	1
zèbrent	z:è:brent|z:E:bR	1
poisse	po:i:sse|pw:a:s	1
peste	p:e:ste|p:E:st	1
serine	se:ri:ne|sR:i:n	1
nouèrent	nou:è:rent|nw:E:R	1
los	lo:s:|l:o:	1
courent	c:ou:rent|k:u:R	1
grises	gr:i:ses|gR:i:z	1
thé	t:hé:|t:e:	1
cornent	c:o:rnent|k:O:Rn	1
diables	di:a:bles|dj:a:bl	1
tors	t:or:s|t:O:R	1
guêtres	g:uê:tres|g:E:tR	1
psaumes	ps:au:mes|ps:o:m	1
tale	t:a:le|t:a:l	1
nions	ni:ons:|nj:§:	1
blaire	bl:ai:re|bl:E:R	1
crêtes	cr:ê:tes|kR:E:t	1
grammes	gr:am:mes|gR:a:m	1
lune	l:u:ne|l:y:n	1
jazz	ja:z:z|dZ:a:z	1
joug	jou:g:|Z:u:	1
mots	m:ots:|m:o:	1
ratte	ra:t:te|R:a:t	1
steak	st:e:ak|st:E:k	1
congre	c:on:gre|k:§:gR	1
boue	b:oue:|b:u:	1
cinq	c:in:q|s:5:k	1
tantes	t:an:tes|t:@:t	1
toisent	toi:s:ent|tw:a:z	1
bruts	br:ut:s|bR:y:t	1
suait	su:ait:|s8:E:	1
luettes	lu:et:tes|l8:E:t	1
sauve	s:au:ve|s:o:v	1
gent	ge:nt:|Z:@:	1
bugnes	b:u:gnes|b:y:N	1
mielle	mie:l:le|mj:E:l	1
penchent	p:en:chent|p:@:S	1
state	st:a:te|st:E:jt	1
risques	r:i:sques|R:i:sk	1
scion	sci:on:|sj:§:	1
limes	l:i:mes|l:i:m	1
chues	ch:ues:|S:y:	1
cueilles	c:ue:illes|k:9:j	1
boite	bo:i:te|bw:a:t	1
mannes	ma:n:nes|m:a:n	1
zef	z:e:f|z:E:f	1
tanche	t:an:che|t:@:S	1
tarte	t:a:rte|t:a:Rt	1
mires	m:i:res|m:i:R	1
bût	b:ût:|b:y:	1
saucent	s:auc:ent|s:o:s	1
bronche	br:on:che|bR:§:S	1
sables	s:a:bles|s:a:bl	1
tristes	tr:i:stes|tR:i:st	1
firmes	f:i:rmes|f:i:Rm	1
tachent	t:a:chent|t:a:S	1
borde	b:o:rde|b:O:Rd	1
palpes	p:a:lpes|p:a:lp	1
plurent	pl:u:rent|pl:y:R	1
jaunes	j:au:nes|Z:o:n	1
gigue	g:i:gue|Z:i:g	1
speed	spe:e:d|sp:i:d	1
brouilles	br:ou:illes|bR:u:j	1
lump	l:um:p|l:1:p	1
heure	:heu:re|:9:R	1
crâne	cr:â:ne|kR:a:n	1
tracts	tr:a:cts|tR:a:kt	1
vau	v:au:|v:o:	1
plaisent	pl:ai:sent|pl:E:z	1
ante	:an:te|:@:t	1
vin	v:in:|v:5:	1
sûres	s:û:res|s:y:R	1
hargne	:ha:rgne|:a:RN	1
ladres	l:a:dres|l:a:dR	1
houille	:h:ouille|:u:j	1
hors	:hor:s|:O:R	1
nais	n:ais:|n:E:	1
nove	n:o:ve|n:O:v	1
courbe	c:ou:rbe|k:u:Rb	1
slice	sl:i:ce|sl:i:s	1
plants	pla:nts:|pl:@:	1
facs	f:a:cs|f:a:k	1
tapes	t:a:pes|t:a:p	1
pairs	p:ai:rs|p:E:R	1
frêne	fr:ê:ne|fR:E:n	1
brosses	br:o:sses|bR:O:s	1
saint	s:aint:|s:5:	1
clowns	cl:o:wns|kl:u:n	1
nippe	n:i:ppe|n:i:p	1
gales	g:a:les|g:a:l	1
fritte	fr:it:te|fR:i:t	1
trots	tr:ots:|tR:o:	1
fat	f:a:t|f:a:t	1
purgent	p:u:rgent|p:y:RZ	1
praires	pr:ai:res|pR:E:R	1
peu	p:eu:|p:2:	1
coqs	c:o:qs|k:O:k	1
fier	fie:r:|fj:e:	1
dormes	d:o:rmes|d:O:Rm	1
soûle	s:oû:le|s:u:l	1
jouxte	j:ou:xte|Z:u:kst	1
socques	s:oc:ques|s:O:k	1
forcent	f:o:rcent|f:O:Rs	1
lé	l:é:|l:e:	1
chue	ch:ue:|S:y:	1
bour	b:ou:r|b:u:R	1
flottent	fl:ot:tent|fl:O:t	1
coache	c:o:ache|k:o:tS	1
sauces	s:au:ces|s:o:s	1
torses	t:o:rses|t:O:Rs	1
trait	tr:ait:|tR:E:	1
capte	c:a:pte|k:a:pt	1
drill	dr:i:ll|dR:i:l	1
graines	gr:ai:nes|gR:E:n	1
prose	pr:o:se|pR:o:z	1
brèmes	br:è:mes|bR:E:m	1
nie	n:ie:|n:i:	1
boues	b:oues:|b:u:	1
puces	p:u:ces|p:y:s	1
pan	p:an:|p:@:	1
hua	hu:a:|8:a:	1
quiètes	qui:è:tes|kj:E:t	1
cague	c:a:gue|k:a:g	1
fît	f:ît:|f:i:	1
bile	b:i:le|b:i:l	1
plein	pl:ein:|pl:5:	1
roue	r:oue:|R:u:	1
chaix	ch:aix:|S:E:	1
ranches	r:a:nches|R:@:nS	1
jambes	j:am:bes|Z:@:b	1
volent	v:o:lent|v:O:l	1
seraient	ser:aient:|sR:E:	1
coursent	c:ou:rsent|k:u:Rs	1
charge	ch:a:rge|S:a:RZ	1
vagues	v:a:gues|v:a:g	1
câbles	c:â:bles|k:a:bl	1
ferme	f:e:rme|f:E:Rm	1
troue	tr:oue:|tR:u:	1
rauque	r:au:que|R:o:k	1
leurs	l:eur:s|l:9:R	1
croche	cr:o:che|kR:O:S	1
drones	dr:o:nes|dR:o:n	1
soldent	s:o:ldent|s:O:ld	1
sèvres	s:è:vres|s:E:vR	1
cheiks	ch:e:iks|S:E:k	1
mande	m:an:de|m:@:d	1
crêt	cr:êt:|kR:E:	1
suent	s:uent:|s:y:	1
paient	p:aient:|p:E:	1
pots	p:ots:|p:o:	1
chants	ch:ants:|S:@:	1
tette	t:et:te|t:E:t	1
mure	m:u:re|m:y:R	1
traînent	tr:aî:nent|tR:E:n	1
blair	bl:ai:r|bl:E:R	1
chiourme	chi:ou:rme|Sj:u:Rm	1
bruines	bru:i:nes|bR8:i:n	1
tric	tr:i:c|tR:i:k	1
gan	g:a:n|g:a:n	1
sticks	st:i:cks|st:i:k	1
chassent	ch:a:ssent|S:a:s	1
vulves	v:u:lves|v:y:lv	1
notes	n:o:tes|n:O:t	1
sut	s:ut:|s:y:	1
joute	j:ou:te|Z:u:t	1
cuites	cu:i:tes|k8:i:t	1
ploucs	pl:ou:cs|pl:u:k	1
cadre	c:a:dre|k:a:dR	1
choeur	c:hoeu:r|k:9:R	1
fiables	fi:a:bles|fj:a:bl	1
bouche	b:ou:che|b:u:S	1
gnole	gn:o:le|N:o:l	1
cubes	c:u:bes|k:y:b	1
putsch	p:u:tsch|p:u:tS	1
car	c:a:r|k:a:R	1
plaints	pla:ints:|pl:5:	1
tub	t:u:b|t:9:b	1
bègue	b:è:gue|b:E:g	1
longes	l:on:ges|l:§:Z	1
sphaignes	sph:ai:gnes|sf:E:N	1
rack	r:a:ck|R:a:k	1
dômes	d:ô:mes|d:o:m	1
dine	d:i:ne|d:i:n	1
bries	br:ies:|bR:i:	1
contrent	c:on:trent|k:§:tR	1
gave	g:a:ve|g:a:v	1
science	sci:en:ce|sj:@:s	1
forte	f:o:rte|f:O:Rt	1
tunes	t:u:nes|t:y:n	1
godent	g:o:dent|g:O:d	1
pintes	p:in:tes|p:5:t	1
floches	fl:o:ches|fl:O:S	1
hum	:hu:m|:9:m	1
jap	j:a:p|Z:a:p	1
bêlent	b:ê:lent|b:E:l	1
parque	p:a:rque|p:a:Rk	1
jouent	jou:ent:|Z:u:	1
spasme	sp:a:sme|sp:a:sm	1
diurnes	di:u:rnes|dj:y:Rn	1
sax	s:a:x|s:a:ks	1
kot	k:o:t|k:O:t	1
branques	br:an:ques|bR:@:k	1
bombes	b:om:bes|b:§:b	1
puer	pu:er:|p8:e:	1
mit	m:it:|m:i:	1
grèges	gr:è:ges|gR:E:Z	1
marcs	m:a:rcs|m:a:R	1
trient	tr:ient:|tR:i:	1
lymphe	l:ymph:e|l:5:f	1
menthes	m:enth:es|m:@:t	1
niche	n:i:che|n:i:S	1
châsses	ch:â:sses|S:a:s	1
roué	rou:é:|Rw:e:	1
latte	la:t:te|l:a:t	1
paume	p:au:me|p:o:m	1
gré	gr:é:|gR:e:	1
chiquent	ch:i:quent|S:i:k	1
ergs	:e:rgs|:E:Rg	1
tague	t:a:gue|t:a:g	1
prise	pr:i:se|pR:i:z	1
frayent	fr:ay:ent|fR:e:j	1
cantre	c:an:tre|k:@:tR	1
plouc	pl:ou:c|pl:u:k	1
lins	l:ins:|l:5:	1
doute	d:ou:te|d:u:t	1
gâches	g:â:ches|g:a:S	1
nuire	nu:i:re|n8:i:R	1
rom	r:o:m|R:O:m	1
loches	l:o:ches|l:O:S	1
pré	pr:é:|pR:e:	1
foie	foi:e:|fw:a:	1
sera	se:ra:|sR:a:	1
haine	:hai:ne|:E:n	1
cents	ce:nts:|s:@:	1
forges	f:o:rges|f:O:RZ	1
ares	:a:res|:a:R	1
fouit	fou:it:|fw:i:	1
gnou	gn:ou:|gn:u:	1
drue	dr:ue:|dR:y:	1
jongle	j:on:gle|Z:§:gl	1
poil	po:i:l|pw:a:l	1
conque	c:on:que|k:§:k	1
sens	s:en:s|s:@:s	1
suaires	su:ai:res|s8:E:R	1
bannes	b:a:nnes|b:a:n	1
pus	p:us:|p:y:	1
presses	pr:e:sses|pR:E:s	1
durs	d:ur:s|d:y:R	1
musclent	m:u:sclent|m:y:skl	1
bombe	b:om:be|b:§:b	1
brand	br:and:|bR:@:	1
goules	g:ou:les|g:u:l	1
heaumes	:heau:mes|:o:m	1
crème	cr:è:me|kR:E:m	1
freines	fr:e:ines|fR:E:n	1
vêpres	v:ê:pres|v:E:pR	1
liment	l:i:ment|l:i:m	1
styles	st:y:les|st:i:l	1
speech	sp:e:ech|sp:i:tS	1
fois	foi:s:|fw:a:	1
scoop	sco:o:p|sk:u:p	1
plouf	pl:ou:f|pl:u:f	1
ombre	:o:mbre|:§:bR	1
place	pl:a:ce|pl:a:s	1
clous	cl:ous:|kl:u:	1
rolle	r:ol:le|R:O:l	1
rouan	rou:an:|Rw:@:	1
stryges	str:y:ges|stR:i:Z	1
chères	ch:è:res|S:E:R	1
ogre	:o:gre|:O:gR	1
cracks	cr:a:cks|kR:a:k	1
niaise	ni:ai:se|nj:E:z	1
click	cl:i:ck|kl:i:k	1
noie	noi:e:|nw:a:	1
verse	v:e:rse|v:E:Rs	1
raire	r:ai:re|R:E:R	1
coach	c:o:ach|k:o:tS	1
spas	sp:as:|sp:a:	1
mitent	m:i:tent|m:i:t	1
pingres	p:in:gres|p:5:gR	1
sieurs	si:eur:s|sj:9:R	1
être	:ê:tre|:E:tR	1
cotres	c:o:tres|k:O:tR	1
coûts	co:ûts:|k:u:	1
vues	v:ues:|v:y:	1
givre	g:i:vre|Z:i:vR	1
toc	t:o:c|t:O:k	1
grave	gr:a:ve|gR:a:v	1
âpres	:â:pres|:a:pR	1
roques	r:o:ques|R:O:k	1
joies	joi:es:|Zw:a:	1
saines	s:ai:nes|s:E:n	1
bagne	b:a:gne|b:a:N	1
mienne	mi:en:ne|mj:E:n	1
lards	l:a:rds|l:a:R	1
chantre	ch:an:tre|S:@:tR	1
bortsch	b:o:rtsch|b:O:RtS	1
tiède	ti:è:de|tj:E:d	1
tope	t:o:pe|t:O:p	1
fourgue	f:ou:rgue|f:u:Rg	1
optes	:o:ptes|:O:pt	1
rament	r:a:ment|R:a:m	1
fêtent	f:ê:tent|f:E:t	1
mate	m:a:te|m:a:t	1
cribles	cr:i:bles|kR:i:bl	1
scelle	s:cel:le|s:E:l	1
crachent	cr:a:chent|kR:a:S	1
tond	t:ond:|t:§:	1
bitte	b:it:te|b:i:t	1
sort	s:or:t|s:O:R	1
chars	ch:a:rs|S:a:R	1
verne	v:e:rne|v:E:Rn	1
trognes	tr:o:gnes|tR:O:N	1
pneu	pn:eu:|pn:2:	1
tuant	tu:ant:|t8:@:	1
ah	:ah:|:a:	1
bugle	b:u:gle|b:y:gl	1
souffres	s:ou:ffres|s:u:fR	1
chiennes	chi:en:nes|Sj:E:n	1
aines	:ai:nes|:E:n	1
sienne	si:en:ne|sj:E:n	1
quarre	qu:ar:re|k:a:R	1
soignes	so:i:gnes|sw:a:N	1
dames	d:a:mes|d:a:m	1
règle	r:è:gle|R:E:gl	1
planche	pl:an:che|pl:@:S	1
kvas	kv:a:s|kv:a:s	1
serins	ser:ins:|sR:5:	1
fichtre	f:i:chtre|f:i:StR	1
fil	f:i:l|f:i:l	1
slush	sl:us:h|sl:9:S	1
gifts	g:i:fts|Z:i:f	1
front	fr:ont:|fR:§:	1
tôle	t:ô:le|t:o:l	1
naître	n:aî:tre|n:E:tR	1
calle	c:al:le|k:a:l	1
fausse	f:au:sse|f:o:s	1
pèchent	p:è:chent|p:E:S	1
froissent	fro:i:ssent|fRw:a:s	1
aire	:ai:re|:E:R	1
smog	sm:o:g|sm:O:g	1
dais	d:ais:|d:E:	1
quittent	qu:it:tent|k:i:t	1
cierge	ci:e:rge|sj:E:RZ	1
fades	f:a:des|f:a:d	1
paons	p:aons:|p:@:	1
pleur	pl:eu:r|pl:9:R	1
pille	p:i:lle|p:i:j	1
pelle	p:el:le|p:E:l	1
rune	r:u:ne|R:y:n	1
dires	d:i:res|d:i:R	1
paire	p:ai:re|p:E:R	1
sparte	sp:a:rte|sp:a:Rt	1
vît	v:ît:|v:i:	1
ksar	ks:a:r|ks:a:R	1
bustes	b:u:stes|b:y:st	1
bée	b:ée:|b:e:	1
jouaient	jou:aient:|Zw:E:	1
miennes	mi:en:nes|mj:E:n	1
graine	gr:ai:ne|gR:E:n	1
nimbes	n:im:bes|n:5:b	1
onc	:on:c|:§:k	1
trombes	tr:om:bes|tR:§:b	1
mornes	m:o:rnes|m:O:Rn	1
bot	b:ot:|b:o:	1
rats	ra:ts:|R:a:	1
files	f:i:les|f:i:l	1
trope	tr:o:pe|tR:O:p	1
mentes	m:en:tes|m:@:t	1
neck	n:e:ck|n:E:k	1
muait	mu:ait:|m8:E:	1
sceptre	sc:e:ptre|s:E:ptR	1
oses	:o:ses|:o:z	1
roubles	r:ou:bles|R:u:bl	1
oui	o:ui:|w:i:	1
porches	p:o:rches|p:O:RS	1
mestre	m:e:stre|m:E:stR	1
chôme	ch:ô:me|S:o:m	1
scopes	sc:o:pes|sk:O:p	1
blesses	bl:e:sses|bl:E:s	1
eus	:eus:|:y:	1
ripe	r:i:pe|R:i:p	1
vont	v:ont:|v:§:	1
moût	mo:ût:|m:u:	1
plaint	pla:int:|pl:5:	1
chiche	ch:i:che|S:i:S	1
mound	m:ou:nd|m:u:nd	1
loup	lou:p:|l:u:	1
tête	t:ê:te|t:E:t	1
chats	ch:ats:|S:a:	1
knout	kn:ou:t|kn:u:t	1
flaches	fl:a:ches|fl:a:S	1
fient	f:ient:|f:i:	1
chopes	ch:o:pes|S:O:p	1
fadent	f:a:dent|f:a:d	1
truie	trui:e:|tR8:i:	1
tannent	t:a:nnent|t:a:n	1
sainte	sa:in:te|s:5:t	1
cordes	c:o:rdes|k:O:Rd	1
fraise	fr:ai:se|fR:E:z	1
mers	m:e:rs|m:E:R	1
tract	tr:a:ct|tR:a:kt	1
rate	r:a:te|R:a:t	1
fronde	fr:on:de|fR:§:d	1
crainte	cra:in:te|kR:5:t	1
caf	c:a:f|k:a:f	1
rogne	r:o:gne|R:O:N	1
flair	fl:ai:r|fl:E:R	1
whig	wh:i:g|w:i:g	1
entrent	:en:trent|:@:tR	1
drainent	dr:ai:nent|dR:E:n	1
vague	v:a:gue|v:a:g	1
suiv	su:i:v|s8:i:v	1
tôt	t:ôt:|t:o:	1
cartes	c:a:rtes|k:a:Rt	1
grooms	gr:o:oms|gR:u:m	1
blettes	bl:et:tes|bl:E:t	1
blonde	bl:on:de|bl:§:d	1
pop	p:o:p|p:O:p	1
zooms	zo:o:ms|z:u:m	1
cakes	cak:e:s|k:E:k	1
sombres	s:om:bres|s:§:bR	1
flinguent	fl:in:guent|fl:5:g	1
brème	br:è:me|bR:E:m	1
cirque	c:i:rque|s:i:Rk	1
mordre	m:o:rdre|m:O:RdR	1
fauve	f:au:ve|f:o:v	1
tante	t:an:te|t:@:t	1
barjes	b:a:rjes|b:a:RZ	1
comblent	co:m:blent|k:§:bl	1
math	m:a:th|m:a:t	1
ragent	r:a:gent|R:a:Z	1
flouze	fl:ou:ze|fl:u:z	1
pistes	p:i:stes|p:i:st	1
seringue	ser:in:gue|sR:5:g	1
thème	t:hè:me|t:E:m	1
soufre	s:ou:fre|s:u:fR	1
drège	dr:è:ge|dR:E:Z	1
crains	cr:ains:|kR:5:	1
rush	r:us:h|R:9:S	1
scellent	s:cel:lent|s:E:l	1
boitent	bo:i:tent|bw:a:t	1
puises	pu:i:ses|p8:i:z	1
gueux	gu:eux:|g:2:	1
quiet	quie:t:|kj:E:	1
cuvent	c:u:vent|k:y:v	1
fers	f:e:rs|f:E:R	1
voûtes	v:oû:tes|v:u:t	1
glass	gl:a:ss|gl:a:s	1
trame	tr:a:me|tR:a:m	1
sautent	s:au:tent|s:o:t	1
ternes	t:e:rnes|t:E:Rn	1
flanquent	fl:an:quent|fl:@:k	1
berge	b:e:rge|b:E:RZ	1
lent	l:ent:|l:@:	1
neige	n:e:ige|n:E:Z	1
prote	pr:o:te|pR:O:t	1
sages	s:a:ges|s:a:Z	1
pense	p:en:se|p:@:s	1
frippe	fr:i:ppe|fR:i:p	1
sacre	s:a:cre|s:a:kR	1
buse	b:u:se|b:y:z	1
crèvent	cr:è:vent|kR:E:v	1
glèbes	gl:è:bes|gl:E:b	1
chiaient	chi:aient:|Sj:E:	1
muant	mu:ant:|m8:@:	1
crochent	cr:o:chent|kR:O:S	1
soldes	s:o:ldes|s:O:ld	1
tuent	t:uent:|t:y:	1
cases	c:a:ses|k:a:z	1
schnock	schn:o:ck|Sn:O:k	1
fusse	f:u:sse|f:y:s	1
ois	oi:s:|w:a:	1
lyre	l:y:re|l:i:R	1
foulques	f:ou:lques|f:u:lk	1
liges	l:i:ges|l:i:Z	1
cloître	clo:î:tre|klw:a:tR	1
crade	cr:a:de|kR:a:d	1
plonges	pl:on:ges|pl:§:Z	1
brooks	br:o:oks|bR:u:k	1
siècle	si:è:cle|sj:E:kl	1
halle	:hal:le|:a:l	1
vu	v:u:|v:y:	1
lynx	l:yn:x|l:5:ks	1
clin	cl:in:|kl:5:	1
seltz	s:e:ltz|s:E:lts	1
tommes	t:om:mes|t:O:m	1
fias	fia:s:|fj:a:	1
lave	l:a:ve|l:a:v	1
couards	cou:a:rds|kw:a:R	1
berthe	b:e:rthe|b:E:Rt	1
couples	c:ou:ples|k:u:pl	1
rabes	r:a:bes|R:a:b	1
longs	lo:ngs:|l:§:	1
acres	:a:cres|:a:kR	1
flot	fl:ot:|fl:o:	1
nèpes	n:è:pes|n:E:p	1
vol	v:o:l|v:O:l	1
foi	fo:i:|fw:a:	1
crèves	cr:è:ves|kR:E:v	1
nice	n:i:ce|n:i:s	1
tuons	tu:ons:|t8:§:	1
luxe	l:u:xe|l:y:ks	1
spire	sp:i:re|sp:i:R	1
jeux	j:eux:|Z:2:	1
jettes	j:et:tes|Z:E:t	1
tannes	t:a:nnes|t:a:n	1
bills	b:i:lls|b:i:l	1
hoche	:ho:che|:O:S	1
huées	h:uées:|8:e:	1
toits	toi:ts:|tw:a:	1
buées	bu:ées:|b8:e:	1
simple	s:i:mple|s:5:pl	1
nerfs	n:e:rfs|n:E:R	1
braquent	br:a:quent|bR:a:k	1
raient	r:aient:|R:E:	1
sonne	s:on:ne|s:O:n	1
teignent	t:e:ignent|t:E:N	1
bis	b:i:s|b:i:s	1
glène	gl:è:ne|gl:E:n	1
forment	f:o:rment|f:O:Rm	1
bornes	b:o:rnes|b:O:Rn	1
nuls	n:u:ls|n:y:l	1
thrace	thr:a:ce|tR:a:s	1
trempe	tr:em:pe|tR:@:p	1
cognent	c:o:gnent|k:O:N	1
bribe	br:i:be|bR:i:b	1
out	:o:ut|:a:wt	1
malm	m:a:lm|m:a:lm	1
faim	f:aim:|f:5:	1
chattes	ch:at:tes|S:a:t	1
fla	fl:a:|fl:a:	1
vouais	vou:ais:|vw:E:	1
jouisses	jou:i:sses|Zw:i:s	1
frottent	fr:ot:tent|fR:O:t	1
vivres	v:i:vres|v:i:vR	1
ruche	r:u:che|R:y:S	1
nacre	n:a:cre|n:a:kR	1
poindre	po:in:dre|pw:5:dR	1
ligues	l:i:gues|l:i:g	1
perses	p:e:rses|p:E:Rs	1
mie	m:ie:|m:i:	1
juan	ju:a:n|Rw:a:n	1
verre	v:er:re|v:E:R	1
fart	f:a:rt|f:a:R	1
migrent	m:i:grent|m:i:gR	1
mon	m:on:|m:§:	1
bide	b:i:de|b:i:d	1
gym	g:y:m|Z:i:m	1
douce	d:ou:ce|d:u:s	1
tifs	t:i:fs|t:i:f	1
clap	cl:a:p|kl:a:p	1
taons	t:aons:|t:@:	1
muaient	mu:aient:|m8:E:	1
tapent	t:a:pent|t:a:p	1
zouave	zou:a:ve|zw:a:v	1
ruée	ru:ée:|R8:e:	1
gouffre	g:ou:ffre|g:u:fR	1
borne	b:o:rne|b:O:Rn	1
rouet	rou:et:|Rw:E:	1
far	f:a:r|f:a:R	1
mark	m:a:rk|m:a:Rk	1
belges	b:e:lges|b:E:lZ	1
vaquent	v:a:quent|v:a:k	1
maints	ma:ints:|m:5:	1
faire	f:ai:re|f:E:R	1
cossent	c:o:ssent|k:O:s	1
geôles	ge:ô:les|Z:o:l	1
bouts	bou:ts:|b:u:	1
valses	v:a:lses|v:a:ls	1
sil	s:i:l|s:i:l	1
lianes	li:a:nes|lj:a:n	1
oing	o:ing:|w:5:	1
fraises	fr:ai:ses|fR:E:z	1
cesse	c:e:sse|s:E:s	1
ourlent	:ou:rlent|:u:Rl	1
testes	t:e:stes|t:E:st	1
ma	m:a:|m:a:	1
blousent	bl:ou:sent|bl:u:z	1
teignes	t:e:ignes|t:E:N	1
cette	ce:t:te|s:E:t	1
sciée	sci:ée:|sj:e:	1
urgent	:u:rgent|:y:RZ	1
croup	cr:ou:p|kR:u:p	1
larme	l:a:rme|l:a:Rm	1
vêtent	v:ê:tent|v:E:t	1
sucrent	s:u:crent|s:y:kR	1
pue	p:ue:|p:y:	1
dogue	d:o:gue|d:O:g	1
zob	z:o:b|z:O:b	1
bouillent	b:ou:illent|b:u:j	1
viorne	vi:o:rne|vj:O:Rn	1
tien	tie:n:|tj:5:	1
mer	m:e:r|m:E:R	1
noble	n:o:ble|n:O:bl	1
lettes	l:et:tes|l:E:t	1
berk	b:e:rk|b:E:Rk	1
jante	j:an:te|Z:@:t	1
preux	pr:eux:|pR:2:	1
taules	t:au:les|t:o:l	1
best	b:e:st|b:E:st	1
popes	p:o:pes|p:O:p	1
fronces	fr:on:ces|fR:§:s	1
grimpe	gr:im:pe|gR:5:p	1
garce	g:a:rce|g:a:Rs	1
whigs	wh:i:gs|w:i:g	1
pèses	p:è:ses|p:E:z	1
crane	cr:a:ne|kR:a:n	1
peuhl	p:euh:l|p:2:l	1
voltes	v:o:ltes|v:O:lt	1
hauts	:hauts:|:o:	1
catch	c:a:tch|k:a:tS	1
blesse	bl:e:sse|bl:E:s	1
traire	tr:ai:re|tR:E:R	1
fère	f:è:re|f:E:R	1
pentes	p:en:tes|p:@:t	1
yeah	ye:ah:|j:E:	1
voilent	vo:i:lent|vw:a:l	1
cuisent	cu:i:sent|k8:i:z	1
staffs	st:a:ffs|st:a:f	1
ancres	:an:cres|:@:kR	1
cerque	c:e:rque|s:E:Rk	1
gicle	g:i:cle|Z:i:kl	1
prêtres	pr:ê:tres|pR:E:tR	1
sauge	s:au:ge|s:o:Z	1
truste	tr:u:ste|tR:9:st	1
blouse	bl:ou:se|bl:u:z	1
courbent	c:ou:rbent|k:u:Rb	1
mob	m:o:b|m:O:b	1
esse	:e:sse|:E:s	1
oust	:ou:st|:u:st	1
stock	st:o:ck|st:O:k	1
prince	pr:in:ce|pR:5:s	1
frappes	fr:a:ppes|fR:a:p	1
but	b:ut:|b:y:	1
roses	r:o:ses|R:o:z	1
vouons	vou:ons:|vw:§:	1
bourde	b:ou:rde|b:u:Rd	1
touche	t:ou:che|t:u:S	1
ente	:en:te|:@:t	1
duels	du:e:ls|d8:E:l	1
dorment	d:o:rment|d:O:Rm	1
suisses	su:i:sses|s8:i:s	1
pleuvent	pl:eu:vent|pl:2:v	1
mus	m:us:|m:y:	1
nègres	n:è:gres|n:E:gR	1
bulbes	b:u:lbes|b:y:lb	1
gommes	g:om:mes|g:O:m	1
veldt	v:e:ldt|v:E:lt	1
skieur	ski:eu:r|skj:9:R	1
sonde	s:on:de|s:§:d	1
pipes	p:i:pes|p:i:p	1
mutent	m:u:tent|m:y:t	1
louange	lou:an:ge|lw:@:Z	1
entres	:en:tres|:@:tR	1
coeurs	co:eur:s|k:9:R	1
fouilles	f:ou:illes|f:u:j	1
chez	ch:ez:|S:e:	1
perce	p:e:rce|p:E:Rs	1
gueule	gu:eu:le|g:9:l	1
pensent	p:en:sent|p:@:s	1
jupes	j:u:pes|Z:y:p	1
racle	r:a:cle|R:a:kl	1
bourgues	b:ou:rgues|b:u:Rg	1
rient	r:ient:|R:i:	1
fende	f:en:de|f:@:d	1
gourdes	g:ou:rdes|g:u:Rd	1
pluies	plui:es:|pl8:i:	1
nuits	nui:ts:|n8:i:	1
ombres	:o:mbres|:§:bR	1
ouailles	ou:a:illes|w:a:j	1
schlingue	schl:in:gue|Sl:5:g	1
scythe	s:cyth:e|s:i:t	1
vesses	v:e:sses|v:E:s	1
gente	g:en:te|Z:@:t	1
froid	froi:d:|fRw:a:	1
boys	b:o:ys|b:O:j	1
bruisse	bru:i:sse|bR8:i:s	1
blaguent	bl:a:guent|bl:a:g	1
squares	squ:a:res|skw:a:R	1
tissent	t:i:ssent|t:i:s	1
vides	v:i:des|v:i:d	1
tords	t:o:rds|t:O:R	1
fare	f:a:re|f:a:R	1
noies	noi:es:|nw:a:	1
vingt	vi:ngt:|v:5:	1
laids	l:aids:|l:E:	1
maque	m:a:que|m:a:k	1
blonds	bl:onds:|bl:§:	1
orbe	:o:rbe|:O:Rb	1
couarde	cou:a:rde|kw:a:Rd	1
moue	m:oue:|m:u:	1
postes	p:o:stes|p:O:st	1
kurdes	k:u:rdes|k:y:Rd	1
glaire	gl:ai:re|gl:E:R	1
miens	mie:ns:|mj:5:	1
dôle	d:ô:le|d:o:l	1
jouât	jou:ât:|Zw:a:	1
stoppent	st:op:pent|st:O:p	1
plue	pl:ue:|pl:y:	1
spoon	spo:o:n|sp:u:n	1
plument	pl:u:ment|pl:y:m	1
glauque	gl:au:que|gl:o:k	1
treilles	tr:e:illes|tR:E:j	1
germent	g:e:rment|Z:E:Rm	1
terne	t:e:rne|t:E:Rn	1
stance	st:an:ce|st:@:s	1
brai	br:ai:|bR:E:	1
air	:ai:r|:E:R	1
tance	t:an:ce|t:@:s	1
ormes	:o:rmes|:O:Rm	1
flaire	fl:ai:re|fl:E:R	1
montres	m:on:tres|m:§:tR	1
neiges	n:ei:ges|n:E:Z	1
rixes	r:i:xes|R:i:ks	1
mars	m:a:rs|m:a:Rs	1
an	:an:|:@:	1
croupe	cr:ou:pe|kR:u:p	1
bosses	b:o:sses|b:O:s	1
pleines	pl:e:ines|pl:E:n	1
mise	m:i:se|m:i:z	1
plaies	pl:aies:|pl:E:	1
luis	lui:s:|l8:i:	1
bop	b:o:p|b:O:p	1
pipe	p:i:pe|p:i:p	1
lice	l:i:ce|l:i:s	1
cardes	c:a:rdes|k:a:Rd	1
kilt	k:i:lt|k:i:lt	1
bourre	b:our:re|b:u:R	1
luges	l:u:ges|l:y:Z	1
vitres	v:i:tres|v:i:tR	1
more	m:o:re|m:O:R	1
affres	:a:ffres|:a:fR	1
huttes	:hut:tes|:y:t	1
haie	:haie:|:E:	1
gaussent	g:au:ssent|g:o:s	1
filles	f:i:lles|f:i:j	1
eux	:eux:|:2:	1
haire	:hai:re|:E:R	1
vouant	vou:ant:|vw:@:	1
aigres	:ai:gres|:E:gR	1
vexent	v:e:xent|v:E:ks	1
pleins	pl:eins:|pl:5:	1
ponce	p:on:ce|p:§:s	1
tomme	t:om:me|t:O:m	1
sers	s:ers:|s:e:	1
est	:e:st|:e:st	1
morde	m:o:rde|m:O:Rd	1
blocs	bl:o:cs|bl:O:k	1
bote	b:o:te|b:O:t	1
voûte	v:oû:te|v:u:t	1
dengue	d:en:gue|d:@:g	1
sise	s:i:se|s:i:z	1
rite	r:i:te|R:i:t	1
zoome	zo:o:me|z:u:m	1
noir	no:i:r|nw:a:R	1
slug	sl:u:g|sl:9:g	1
veilles	v:e:illes|v:E:j	1
brousses	br:ou:sses|bR:u:s	1
coptes	c:o:ptes|k:O:pt	1
voix	voi:x:|vw:a:	1
laide	l:ai:de|l:E:d	1
noeuds	no:euds:|n:2:	1
pep	p:e:p|p:E:p	1
ouvre	:ou:vre|:u:vR	1
raye	ra:y:e|R:e:j	1
gruge	gr:u:ge|gR:y:Z	1
prompte	pr:omp:te|pR:§:t	1
puisse	pu:i:sse|p8:i:s	1
neutres	n:eu:tres|n:2:tR	1
trique	tr:i:que|tR:i:k	1
lette	l:et:te|l:E:t	1
peintre	pe:in:tre|p:5:tR	1
stoppes	st:op:pes|st:O:p	1
ost	:o:st|:O:st	1
mufles	m:u:fles|m:y:fl	1
range	r:an:ge|R:@:Z	1
jades	j:a:des|Z:a:d	1
noises	noi:s:es|nw:a:z	1
lofe	l:o:fe|l:O:f	1
ives	:i:ves|:i:v	1
grinces	gr:in:ces|gR:5:s	1
niques	n:i:ques|n:i:k	1
tif	t:i:f|t:i:f	1
cycles	c:y:cles|s:i:kl	1
peuplent	p:eu:plent|p:2:pl	1
ouï	ou:ï:|w:i:	1
gué	g:ué:|g:e:	1
rires	r:i:res|R:i:R	1
fit	f:it:|f:i:	1
jouets	jou:ets:|Zw:E:	1
tanks	t:an:ks|t:@:k	1
zestes	z:e:stes|z:E:st	1
gît	g:ît:|Z:i:	1
crib	cr:i:b|kR:i:b	1
fîmes	f:î:mes|f:i:m	1
poêle	po:ê:le|pw:a:l	1
dune	d:u:ne|d:y:n	1
gire	g:i:re|Z:i:R	1
frôle	fr:ô:le|fR:o:l	1
lisent	l:i:sent|l:i:z	1
gniards	gni:a:rds|N:a:R	1
bah	b:ah:|b:a:	1
prônent	pr:ô:nent|pR:o:n	1
aime	:ai:me|:E:m	1
volt	v:o:lt|v:O:lt	1
chaises	ch:ai:ses|S:E:z	1
sabre	s:a:bre|s:a:bR	1
thym	t:hym:|t:5:	1
boss	b:o:ss|b:O:s	1
vainquent	va:in:quent|v:5:k	1
vasque	v:a:sque|v:a:sk	1
zeste	z:e:ste|z:E:st	1
nui	nu:i:|n8:i:	1
sprinte	spr:i:nte|spR:i:nt	1
chancre	ch:an:cre|S:@:kR	1
boucs	b:ou:cs|b:u:k	1
philtre	ph:i:ltre|f:i:ltR	1
soupe	s:ou:pe|s:u:p	1
baltes	b:a:ltes|b:a:lt	1
trottes	tr:ot:tes|tR:O:t	1
freine	fr:e:ine|fR:E:n	1
sons	s:ons:|s:§:	1
mais	m:ais:|m:E:	1
gèles	g:è:les|Z:E:l	1
raines	r:ai:nes|R:E:n	1
cache	c:a:che|k:a:S	1
schah	sch:ah:|S:a:	1
dorme	d:o:rme|d:O:Rm	1
gouges	g:ou:ges|g:u:Z	1
saufs	s:au:fs|s:o:f	1
lie	l:ie:|l:i:	1
tant	t:ant:|t:@:	1
hache	:ha:che|:a:S	1
cold	c:o:ld|k:o:ld	1
quimpent	qu:im:pent|k:5:p	1
fort	f:or:t|f:O:R	1
traquent	tr:a:quent|tR:a:k	1
tune	t:u:ne|t:y:n	1
scions	sci:ons:|sj:§:	1
jonque	j:on:que|Z:§:k	1
tresses	tr:e:sses|tR:E:s	1
jean	je:a:n|dZ:i:n	1
lais	l:ais:|l:E:	1
magne	m:a:gne|m:a:N	1
sketchs	sk:e:tchs|sk:E:tS	1
bonzes	b:on:zes|b:§:z	1
coir	co:i:r|kw:a:R	1
casques	c:a:sques|k:a:sk	1
fables	f:a:bles|f:a:bl	1
nope	n:o:pe|n:O:p	1
boucles	b:ou:cles|b:u:kl	1
maire	m:ai:re|m:E:R	1
monte	m:on:te|m:§:t	1
hem	:he:m|:E:m	1
truffe	tr:u:ffe|tR:y:f	1
souille	s:ou:ille|s:u:j	1
limbes	li:m:bes|l:5:b	1
profs	pr:o:fs|pR:O:f	1
bringue	br:in:gue|bR:5:g	1
parr	p:ar:r|p:a:R	1
blême	bl:ê:me|bl:E:m	1
news	ne:w:s|nj:u:z	1
faces	f:a:ces|f:a:s	1
flips	fl:i:ps|fl:i:p	1
veuve	v:eu:ve|v:9:v	1
riais	ri:ais:|Rj:E:	1
anche	:an:che|:@:S	1
flag	fl:a:g|fl:a:g	1
taxes	t:a:xes|t:a:ks	1
quint	qu:int:|k:5:	1
seule	s:eu:le|s:9:l	1
veines	ve:i:nes|v:E:n	1
tondre	t:on:dre|t:§:dR	1
quiches	qu:i:ches|k:i:S	1
traites	tr:ai:tes|tR:E:t	1
asthmes	:a:sthmes|:a:sm	1
schlem	schl:e:m|Sl:E:m	1
chieur	chi:eu:r|Sj:9:R	1
hase	:ha:se|:a:z	1
sanglent	s:an:glent|s:@:gl	1
quais	qu:ais:|k:e:	1
torde	t:o:rde|t:O:Rd	1
fourrent	f:our:rent|f:u:R	1
string	str:i:ng|stR:i:G	1
keufs	k:eu:fs|k:9:f	1
rittes	r:it:tes|R:i:t	1
alpes	:a:lpes|:a:lp	1
cairn	c:ai:rn|k:E:Rn	1
cierges	ci:e:rges|sj:E:RZ	1
lu	l:u:|l:y:	1
tonnent	t:on:nent|t:O:n	1
ache	:a:che|:a:S	1
coulent	c:ou:lent|k:u:l	1
harpe	:ha:rpe|:a:Rp	1
peul	p:eu:l|p:2:l	1
poils	poi:l:s|pw:a:l	1
ers	:er:s|:E:R	1
russes	r:u:sses|R:y:s	1
ce	c:e:|s:2:	1
chialent	chi:a:lent|Sj:a:l	1
freaks	fr:e:aks|fR:E:k	1
cal	c:a:l|k:a:l	1
deuil	d:eu:il|d:9:j	1
gentes	g:en:tes|Z:@:t	1
flip	fl:i:p|fl:i:p	1
ploie	ploi:e:|plw:a:	1
craignent	cr:ai:gnent|kR:E:N	1
fourbes	f:ou:rbes|f:u:Rb	1
zigues	z:i:gues|z:i:g	1
signes	s:i:gnes|s:i:N	1
chiasme	chi:a:sme|kj:a:sm	1
drible	dr:i:ble|dR:i:bl	1
boom	bo:o:m|b:u:m	1
chaussent	ch:au:ssent|S:o:s	1
fourchent	f:ou:rchent|f:u:RS	1
prompt	pr:ompt:|pR:§:	1
tache	t:a:che|t:a:S	1
pive	p:i:ve|p:i:v	1
luirent	lu:i:rent|l8:i:R	1
jouissent	jou:i:ssent|Zw:i:s	1
couilles	c:ou:illes|k:u:j	1
comme	co:m:me|k:O:m	1
verstes	v:e:rstes|v:E:Rst	1
diode	di:o:de|dj:O:d	1
huile	hu:i:le|8:i:l	1
kiosks	ki:o:sks|kj:O:sk	1
met	m:et:|m:E:	1
culs	c:uls:|k:y:	1
draguent	dr:a:guent|dR:a:g	1
buis	bui:s:|b8:i:	1
trucs	tr:u:cs|tR:y:k	1
saoulent	sa:ou:lent|s:u:l	1
moires	mo:i:res|mw:a:R	1
pèles	p:è:les|p:E:l	1
rieurs	ri:eur:s|Rj:9:R	1
zens	z:e:ns|z:E:n	1
ace	:a:ce|:a:s	1
plèvre	pl:è:vre|pl:E:vR	1
chut	ch:u:t|S:y:t	1
gaines	g:ai:nes|g:E:n	1
fez	f:e:z|f:E:z	1
ponde	p:on:de|p:§:d	1
angle	:an:gle|:@:gl	1
proc	pr:o:c|pR:O:k	1
banque	b:an:que|b:@:k	1
gardes	g:a:rdes|g:a:Rd	1
rouages	rou:a:ges|Rw:a:Z	1
lem	l:e:m|l:E:m	1
lape	l:a:pe|l:a:p	1
mottes	mo:t:tes|m:O:t	1
lopes	l:o:pes|l:O:p	1
trente	tr:en:te|tR:@:t	1
caques	c:a:ques|k:a:k	1
billes	b:i:lles|b:i:j	1
colts	c:o:lts|k:O:lt	1
vils	v:i:ls|v:i:l	1
raid	r:ai:d|R:E:d	1
clone	cl:o:ne|kl:o:n	1
basses	b:a:sses|b:a:s	1
larges	l:a:rges|l:a:RZ	1
bribes	br:i:bes|bR:i:b	1
fastes	f:a:stes|f:a:st	1
houe	:houe:|:u:	1
mâches	m:â:ches|m:a:S	1
pannes	p:a:nnes|p:a:n	1
pneus	pn:eus:|pn:2:	1
soule	s:ou:le|s:u:l	1
aigles	:ai:gles|:E:gl	1
godes	g:o:des|g:O:d	1
wharf	wh:a:rf|w:a:Rf	1
mam	m:a:m|m:a:m	1
pouf	p:ou:f|p:u:f	1
crash	cr:a:sh|kR:a:S	1
oigne	o:i:gne|w:a:N	1
couse	c:ou:se|k:u:z	1
mouise	mou:i:se|mw:i:z	1
coeur	co:eu:r|k:9:R	1
sois	soi:s:|sw:a:	1
laves	l:a:ves|l:a:v	1
ousque	:ou:sque|:u:sk	1
skeets	ske:e:ts|sk:i:t	1
peuple	p:eu:ple|p:2:pl	1
louâmes	lou:â:mes|lw:a:m	1
brou	br:ou:|bR:u:	1
saur	s:au:r|s:o:R	1
clair	cl:ai:r|kl:E:R	1
franche	fr:an:che|fR:@:S	1
fumes	f:u:mes|f:y:m	1
gagne	g:a:gne|g:a:N	1
blèche	bl:è:che|bl:E:S	1
jusque	j:u:sque|Z:y:sk	1
senne	s:en:ne|s:E:n	1
gerbent	g:e:rbent|Z:E:Rb	1
aubes	:au:bes|:o:b	1
bides	b:i:des|b:i:d	1
dalle	d:al:le|d:a:l	1
bous	bou:s:|b:u:	1
ogres	:o:gres|:O:gR	1
beige	b:e:ige|b:E:Z	1
snipe	sn:i:pe|sn:i:p	1
kir	k:i:r|k:i:R	1
erres	:er:res|:E:R	1
langes	l:an:ges|l:@:Z	1
jà	j:à:|Z:a:	1
cancre	c:an:cre|k:@:kR	1
mouillent	m:ou:illent|m:u:j	1
bon	b:on:|b:§:	1
errent	:er:rent|:E:R	1
mot	m:ot:|m:o:	1
nazes	n:a:zes|n:a:z	1
tiennent	ti:en:nent|tj:E:n	1
noise	noi:s:e|nw:a:z	1
choc	ch:o:c|S:O:k	1
gabe	g:a:be|g:a:b	1
trick	tr:i:ck|tR:i:k	1
combes	co:m:bes|k:§:b	1
ourses	:ou:rses|:u:Rs	1
euh	:euh:|:2:	1
gag	g:a:g|g:a:g	1
marque	m:a:rque|m:a:Rk	1
skaï	sk:a:ï|sk:a:j	1
arcs	:a:rcs|:a:Rk	1
muscle	m:u:scle|m:y:skl	1
lis	l:i:s|l:i:s	1
fûts	f:ûts:|f:y:	1
bailles	b:a:illes|b:a:j	1
lus	l:us:|l:y:	1
mos	m:o:s|m:o:s	1
dîmes	d:î:mes|d:i:m	1
perds	p:e:rds|p:E:R	1
bib	b:i:b|b:i:b	1
pois	poi:s:|pw:a:	1
gonde	g:on:de|g:§:d	1
tondes	t:on:des|t:§:d	1
czar	cz:a:r|kz:a:R	1
vert	v:e:rt|v:E:R	1
dressent	dr:e:ssent|dR:E:s	1
mince	m:in:ce|m:5:s	1
châles	ch:â:les|S:a:l	1
marles	m:a:rles|m:a:Rl	1
watts	w:a:tts|w:a:t	1
rouies	rou:ies:|Rw:i:	1
tem	t:e:m|t:E:m	1
sua	su:a:|s8:a:	1
verge	v:e:rge|v:E:RZ	1
taupes	t:au:pes|t:o:p	1
dot	d:o:t|d:O:t	1
shows	s:hows:|S:o:	1
pile	p:i:le|p:i:l	1
beuglent	b:eu:glent|b:2:gl	1
marnes	m:a:rnes|m:a:Rn	1
sueur	su:eu:r|s8:9:R	1
marrent	m:ar:rent|m:a:R	1
fret	fr:et:|fR:E:	1
prissent	pr:i:ssent|pR:i:s	1
biche	b:i:che|b:i:S	1
daube	d:au:be|d:o:b	1
boit	boi:t:|bw:a:	1
bang	b:an:g|b:@:g	1
sac	s:a:c|s:a:k	1
tresse	tr:e:sse|tR:E:s	1
gèle	g:è:le|Z:E:l	1
strings	str:i:ngs|stR:i:G	1
pièce	pi:è:ce|pj:E:s	1
renflent	r:en:flent|R:@:fl	1
noua	nou:a:|nw:a:	1
tousse	t:ou:sse|t:u:s	1
bouille	b:ou:ille|b:u:j	1
rave	r:a:ve|R:a:v	1
monstre	m:on:stre|m:§:stR	1
bas	b:as:|b:a:	1
girl	g:i:rl|g:9:Rl	1
sylphes	s:y:lphes|s:i:lf	1
bogues	b:o:gues|b:O:g	1
franges	fr:an:ges|fR:@:Z	1
chnoque	chn:o:que|Sn:O:k	1
tuer	tu:er:|t8:e:	1
lourdes	l:ou:rdes|l:u:Rd	1
puant	pu:ant:|p8:@:	1
luette	lu:et:te|l8:E:t	1
bloum	bl:ou:m|bl:u:m	1
quoi	quo:i:|kw:a:	1
rode	r:o:de|R:o:d	1
main	ma:in:|m:5:	1
tendres	t:en:dres|t:@:dR	1
songes	s:on:ges|s:§:Z	1
plies	pl:ies:|pl:i:	1
trans	tr:an:s|tR:@:s	1
bible	b:i:ble|b:i:bl	1
eues	:eues:|:y:	1
rampe	r:am:pe|R:@:p	1
axe	:a:xe|:a:ks	1
flambe	fla:m:be|fl:@:b	1
cadres	c:a:dres|k:a:dR	1
morve	m:o:rve|m:O:Rv	1
gâte	g:â:te|g:a:t	1
dextre	d:e:xtre|d:E:kstR	1
zeb	z:e:b|z:E:b	1
jatte	ja:t:te|Z:a:t	1
boc	b:o:c|b:O:k	1
bif	b:i:f|b:i:f	1
glisse	gl:i:sse|gl:i:s	1
prouves	pr:ou:ves|pR:u:v	1
chiantes	chi:an:tes|Sj:@:t	1
cross	cr:o:ss|kR:O:s	1
versent	v:e:rsent|v:E:Rs	1
dise	d:i:se|d:i:z	1
gros	gr:os:|gR:o:	1
spasmes	sp:a:smes|sp:a:sm	1
quinte	qu:in:te|k:5:t	1
gercent	g:e:rcent|Z:E:Rs	1
stone	st:o:ne|st:o:n	1
calment	c:a:lment|k:a:lm	1
optent	:o:ptent|:O:pt	1
l'un	l:'un:|l:1:	1
câpres	c:â:pres|k:a:pR	1
jouable	jou:a:ble|Zw:a:bl	1
ponte	p:on:te|p:§:t	1
flûte	fl:û:te|fl:y:t	1
vertes	v:e:rtes|v:E:Rt	1
tient	tie:nt:|tj:5:	1
flirte	fl:i:rte|fl:9:Rt	1
dîne	d:î:ne|d:i:n	1
meugle	m:eu:gle|m:2:gl	1
veule	v:eu:le|v:2:l	1
juges	j:u:ges|Z:y:Z	1
creux	cr:eux:|kR:2:	1
bandes	b:an:des|b:@:d	1
boum	b:ou:m|b:u:m	1
frits	fr:its:|fR:i:	1
chiant	chi:ant:|Sj:@:	1
temple	t:e:mple|t:@:pl	1
fange	f:an:ge|f:@:Z	1
manches	m:an:ches|m:@:S	1
masque	m:a:sque|m:a:sk	1
tue	t:ue:|t:y:	1
maies	m:aies:|m:E:	1
torque	t:o:rque|t:O:Rk	1
fac	f:a:c|f:a:k	1
gomment	g:om:ment|g:O:m	1
brais	br:ais:|bR:E:	1
voua	vou:a:|vw:a:	1
tûmes	t:û:mes|t:y:m	1
pales	p:a:les|p:a:l	1
yacht	ya:ch:t|j:O:t	1
bises	b:i:ses|b:i:z	1
pacs	p:a:cs|p:a:ks	1
scythes	s:cyth:es|s:i:t	1
fûtes	f:û:tes|f:y:t	1
cherchent	ch:e:rchent|S:E:RS	1
dusse	d:u:sse|d:y:s	1
hisse	:hi:sse|:i:s	1
cygnes	c:y:gnes|s:i:N	1
gaies	g:aies:|g:e:	1
morgue	m:o:rgue|m:O:Rg	1
chourent	ch:ou:rent|S:u:R	1
chus	ch:us:|S:y:	1
prix	pr:ix:|pR:i:	1
viocs	vi:o:cs|vj:O:k	1
gnôle	gn:ô:le|N:o:l	1
aident	:ai:dent|:E:d	1
cour	c:ou:r|k:u:R	1
niais	ni:ais:|nj:E:	1
mêlent	m:ê:lent|m:E:l	1
pif	p:i:f|p:i:f	1
biaise	bi:ai:se|bj:E:z	1
cran	cr:an:|kR:@:	1
truisme	tru:i:sme|tR8:i:zm	1
pends	p:ends:|p:@:	1
zappe	z:a:ppe|z:a:p	1
gaufres	g:au:fres|g:o:fR	1
dribble	dr:i:bble|dR:i:bl	1
proies	proi:es:|pRw:a:	1
yang	y:an:g|j:@:g	1
turnes	t:u:rnes|t:y:Rn	1
cloche	cl:o:che|kl:O:S	1
dabs	d:a:bs|d:a:b	1
prang	pr:an:g|pR:@:g	1
nixe	n:i:xe|n:i:ks	1
rases	r:a:ses|R:a:z	1
bite	b:i:te|b:i:t	1
trembles	tr:e:mbles|tR:@:bl	1
fox	f:o:x|f:O:ks	1
crament	cr:a:ment|kR:a:m	1
mats	m:a:ts|m:a:t	1
pâles	p:â:les|p:a:l	1
causses	c:au:sses|k:o:s	1
spray	spr:a:y|spR:E:j	1
faix	f:aix:|f:E:	1
poings	poi:ngs:|pw:5:	1
couques	c:ou:ques|k:u:k	1
campe	c:am:pe|k:@:p	1
fardent	f:a:rdent|f:a:Rd	1
zinc	z:in:c|z:5:g	1
tranches	tr:an:ches|tR:@:S	1
pioches	pi:o:ches|pj:O:S	1
stèles	st:è:les|st:E:l	1
pignes	p:i:gnes|p:i:N	1
riches	r:i:ches|R:i:S	1
derme	d:e:rme|d:E:Rm	1
chotts	ch:ott:s|S:O:t	1
rôt	r:ôt:|R:o:	1
bouge	b:ou:ge|b:u:Z	1
rentre	r:en:tre|R:@:tR	1
chambrent	ch:a:mbrent|S:@:bR	1
oeuvres	:oe:uvres|:9:vR	1
palpent	p:a:lpent|p:a:lp	1
fixe	f:i:xe|f:i:ks	1
brumes	br:u:mes|bR:y:m	1
pchitt	pch:i:tt|pS:i:t	1
eau	:eau:|:o:	1
lompe	l:om:pe|l:§:p	1
soie	soi:e:|sw:a:	1
schlague	schl:a:gue|Sl:a:g	1
pend	p:end:|p:@:	1
fripent	fr:i:pent|fR:i:p	1
puise	pu:i:se|p8:i:z	1
prunes	pr:u:nes|pR:y:n	1
gables	g:a:bles|g:a:bl	1
peintes	pe:in:tes|p:5:t	1
goums	g:ou:ms|g:u:m	1
lûmes	l:û:mes|l:y:m	1
porque	p:o:rque|p:O:Rk	1
rêvent	r:ê:vent|R:E:v	1
vantent	v:an:tent|v:@:t	1
armes	:a:rmes|:a:Rm	1
lèse	l:è:se|l:E:z	1
cube	c:u:be|k:y:b	1
hard	:ha:rd|:a:Rd	1
ride	r:i:de|R:i:d	1
couettes	cou:et:tes|kw:E:t	1
auges	:au:ges|:o:Z	1
chauffes	ch:au:ffes|S:o:f	1
dieux	die:ux:|dj:2:	1
aches	:a:ches|:a:S	1
do	d:o:|d:o:	1
bluff	bl:u:ff|bl:9:f	1
souffle	s:ou:ffle|s:u:fl	1
pèle	p:è:le|p:E:l	1
dross	dr:o:ss|dR:O:s	1
rible	r:i:ble|R:i:bl	1
squire	squ:i:re|skw:a:jR	1
lièvres	li:è:vres|lj:E:vR	1
skier	skie:r:|skj:e:	1
gypse	g:y:pse|Z:i:ps	1
suis	sui:s:|s8:i:	1
robes	r:o:bes|R:O:b	1
vinrent	v:in:rent|v:5:R	1
clics	cl:i:cs|kl:i:k	1
dois	doi:s:|dw:a:	1
lièrent	li:è:rent|lj:E:R	1
plaine	pl:ai:ne|pl:E:n	1
orques	:o:rques|:O:Rk	1
chambre	ch:a:mbre|S:@:bR	1
green	gr:e:en|gR:i:n	1
nière	ni:è:re|nj:E:R	1
y	:y:|:i:	1
jeûnent	j:eû:nent|Z:2:n	1
chiard	chi:a:rd|Sj:a:R	1
partent	p:a:rtent|p:a:Rt	1
veuillent	v:eu:illent|v:9:j	1
biffe	b:i:ffe|b:i:f	1
site	s:i:te|s:i:t	1
stockent	st:o:ckent|st:O:k	1
jougs	jou:gs:|Z:u:	1
crises	cr:i:ses|kR:i:z	1
tacs	t:a:cs|t:a:k	1
crû	cr:û:|kR:y:	1
livres	l:i:vres|l:i:vR	1
seau	s:eau:|s:o:	1
kip	k:i:p|k:i:p	1
bouse	b:ou:se|b:u:z	1
sauts	s:auts:|s:o:	1
puais	pu:ais:|p8:E:	1
tremblent	tr:e:mblent|tR:@:bl	1
sveltes	sv:e:ltes|sv:E:lt	1
lampe	l:am:pe|l:@:p	1
zen	z:e:n|z:E:n	1
borgne	b:o:rgne|b:O:RN	1
chlingues	chl:in:gues|Sl:5:g	1
couacs	cou:a:cs|kw:a:k	1
furent	f:u:rent|f:y:R	1
soft	s:o:ft|s:O:ft	1
jasent	j:a:sent|Z:a:z	1
crache	cr:a:che|kR:a:S	1
haussent	:hau:ssent|:o:s	1
rompe	r:om:pe|R:§:p	1
croîs	cro:îs:|kRw:a:	1
femme	f:e:mme|f:a:m	1
ripes	r:i:pes|R:i:p	1
roués	rou:és:|Rw:e:	1
pètent	p:è:tent|p:E:t	1
arme	:a:rme|:a:Rm	1
dompte	d:om:pte|d:§:pt	1
norme	n:o:rme|n:O:Rm	1
viols	vi:o:ls|vj:O:l	1
grince	gr:in:ce|gR:5:s	1
caftes	c:a:ftes|k:a:ft	1
chausses	ch:au:sses|S:o:s	1
squats	squ:a:ts|skw:a:t	1
glaive	gl:ai:ve|gl:E:v	1
née	n:ée:|n:e:	1
braque	br:a:que|bR:a:k	1
frottes	fr:ot:tes|fR:O:t	1
piots	pi:ots:|pj:o:	1
liasses	li:a:sses|lj:a:s	1
rôde	r:ô:de|R:o:d	1
troque	tr:o:que|tR:O:k	1
bale	b:a:le|b:a:l	1
pleutres	pl:eu:tres|pl:2:tR	1
vignes	v:i:gnes|v:i:N	1
froc	fr:o:c|fR:O:k	1
broques	br:o:ques|bR:O:k	1
rognes	r:o:gnes|R:O:N	1
drache	dr:a:che|dR:a:S	1
merl	m:e:rl|m:E:Rl	1
droits	droi:ts:|dRw:a:	1
ban	b:an:|b:@:	1
bette	b:et:te|b:E:t	1
sembles	s:e:mbles|s:@:bl	1
broient	broi:ent:|bRw:a:	1
fade	f:a:de|f:a:d	1
bel	b:e:l|b:E:l	1
puisent	pu:i:sent|p8:i:z	1
nobles	n:o:bles|n:O:bl	1
frais	fr:ais:|fR:E:	1
tiare	ti:a:re|tj:a:R	1
kief	ki:e:f|kj:E:f	1
pounds	p:o:unds|p:a:wndz	1
oie	o:ie:|w:a:	1
antres	:an:tres|:@:tR	1
schtroumpf	schtr:ou:mpf|StR:u:mf	1
perles	p:e:rles|p:E:Rl	1
serf	s:e:rf|s:E:R	1
fondre	f:on:dre|f:§:dR	1
caltent	c:a:ltent|k:a:lt	1
miasmes	mi:a:smes|mj:a:sm	1
lieues	lie:ues:|lj:2:	1
meurtre	m:eu:rtre|m:9:RtR	1
prouve	pr:ou:ve|pR:u:v	1
dague	d:a:gue|d:a:g	1
courges	c:ou:rges|k:u:RZ	1
louis	lou:is:|lw:i:	1
viornes	vi:o:rnes|vj:O:Rn	1
tos	t:os:|t:o:	1
sceau	s:ceau:|s:o:	1
gants	g:ants:|g:@:	1
cèdent	c:è:dent|s:E:d	1
jungle	j:u:ngle|Z:1:gl	1
parthe	p:a:rthe|p:a:Rt	1
coince	co:in:ce|kw:5:s	1
lustres	l:u:stres|l:y:stR	1
règlent	r:è:glent|R:E:gl	1
paonne	p:a:onne|p:a:n	1
lynch	l:yn:ch|l:5:S	1
mû	m:û:|m:y:	1
chiffre	ch:i:ffre|S:i:fR	1
nappe	n:a:ppe|n:a:p	1
ronde	r:on:de|R:§:d	1
caillent	c:a:illent|k:a:j	1
lèves	l:è:ves|l:E:v	1
chatte	ch:at:te|S:a:t	1
douves	d:ou:ves|d:u:v	1
drap	dr:ap:|dR:a:	1
couve	c:ou:ve|k:u:v	1
sniffent	sn:i:ffent|sn:i:f	1
suisse	su:i:sse|s8:i:s	1
fronts	fr:onts:|fR:§:	1
combles	co:m:bles|k:§:bl	1
cuistre	cu:i:stre|k8:i:stR	1
squales	squ:a:les|skw:a:l	1
rustre	r:u:stre|R:y:stR	1
quetsches	qu:e:tsches|kw:E:tS	1
aulx	:aulx:|:o:	1
hâves	:hâ:ves|:a:v	1
bites	b:i:tes|b:i:t	1
berne	b:e:rne|b:E:Rn	1
bri	br:i:|bR:i:	1
probe	pr:o:be|pR:O:b	1
sont	s:ont:|s:§:	1
chiées	chi:ées:|Sj:e:	1
tuante	tu:an:te|t8:@:t	1
romps	ro:mps:|R:§:	1
liard	li:a:rd|lj:a:R	1
nomment	no:m:ment|n:O:m	1
tâchent	t:â:chent|t:a:S	1
chopent	ch:o:pent|S:O:p	1
magnes	m:a:gnes|m:a:N	1
pampres	p:am:pres|p:@:pR	1
bail	b:a:il|b:a:j	1
moules	m:ou:les|m:u:l	1
plaid	pl:ai:d|pl:E:d	1
fiancent	fi:anc:ent|fj:@:s	1
cendre	c:en:dre|s:@:dR	1
grotte	gr:ot:te|gR:O:t	1
nies	n:ies:|n:i:	1
tonne	t:on:ne|t:O:n	1
traitent	tr:ai:tent|tR:E:t	1
chié	chi:é:|Sj:e:	1
pondes	p:on:des|p:§:d	1
triple	tr:i:ple|tR:i:pl	1
cluses	cl:u:ses|kl:y:z	1
chlore	chl:o:re|kl:O:R	1
lire	l:i:re|l:i:R	1
nagent	n:a:gent|n:a:Z	1
rotes	r:o:tes|R:O:t	1
luit	lui:t:|l8:i:	1
nasse	n:a:sse|n:a:s	1
pulpe	p:u:lpe|p:y:lp	1
forge	f:o:rge|f:O:RZ	1
schisme	sch:i:sme|S:i:zm	1
scat	sc:a:t|sk:a:t	1
râlent	r:â:lent|R:a:l	1
planes	pl:a:nes|pl:a:n	1
gerces	g:e:rces|Z:E:Rs	1
bisque	b:i:sque|b:i:sk	1
blase	bl:a:se|bl:a:z	1
vergnes	v:e:rgnes|v:E:RN	1
teille	t:e:ille|t:E:j	1
keum	k:eu:m|k:2:m	1
test	t:e:st|t:E:st	1
riens	rie:ns:|Rj:5:	1
use	:u:se|:y:z	1
nouées	nou:ées:|nw:e:	1
charres	ch:ar:res|S:a:R	1
taube	t:au:be|t:o:b	1
battent	b:at:tent|b:a:t	1
psi	ps:i:|ps:i:	1
sable	s:a:ble|s:a:bl	1
lèvent	l:è:vent|l:E:v	1
meurtres	m:eu:rtres|m:9:RtR	1
blatte	bla:t:te|bl:a:t	1
halls	:hall:s|:o:l	1
gaie	g:aie:|g:E:	1
grand	gr:and:|gR:@:	1
jacte	j:a:cte|Z:a:kt	1
liens	lie:ns:|lj:5:	1
gardent	g:a:rdent|g:a:Rd	1
normes	n:o:rmes|n:O:Rm	1
peau	p:eau:|p:o:	1
fief	fi:e:f|fj:E:f	1
scouts	sc:ou:ts|sk:u:t	1
tertre	t:e:rtre|t:E:RtR	1
fassent	f:a:ssent|f:a:s	1
fîtes	f:î:tes|f:i:t	1
turf	t:u:rf|t:y:Rf	1
beaufs	b:e:aufs|b:o:f	1
folle	f:ol:le|f:O:l	1
bâts	b:âts:|b:a:	1
rein	re:in:|R:5:	1
dab	d:a:b|d:a:b	1
conne	co:n:ne|k:O:n	1
brouille	br:ou:ille|bR:u:j	1
targuent	t:a:rguent|t:a:Rg	1
voûtent	v:oû:tent|v:u:t	1
noms	no:ms:|n:§:	1
sciage	sci:a:ge|sj:a:Z	1
chiait	chi:ait:|Sj:E:	1
scotch	sc:o:tch|sk:O:tS	1
sandre	s:an:dre|s:@:dR	1
miel	mi:e:l|mj:E:l	1
havres	:ha:vres|:a:vR	1
talc	t:a:lc|t:a:lk	1
âcres	:â:cres|:a:kR	1
fiacres	fi:a:cres|fj:a:kR	1
philtres	ph:i:ltres|f:i:ltR	1
trais	tr:ais:|tR:E:	1
barge	b:a:rge|b:a:RZ	1
peinent	p:e:inent|p:E:n	1
grèvent	gr:è:vent|gR:E:v	1
mole	m:o:le|m:O:l	1
funk	f:un:k|f:1:k	1
broie	broi:e:|bRw:a:	1
fourbe	f:ou:rbe|f:u:Rb	1
molle	m:ol:le|m:O:l	1
miche	m:i:che|m:i:S	1
fjords	fj:o:rds|fj:O:Rd	1
gerbe	g:e:rbe|Z:E:Rb	1
lapent	l:a:pent|l:a:p	1
du	d:u:|d:y:	1
couic	cou:i:c|kw:i:k	1
ponts	p:onts:|p:§:	1
haute	:hau:te|:o:t	1
ruâmes	ru:â:mes|R8:a:m	1
jar	j:a:r|Z:a:R	1
malles	ma:l:les|m:a:l	1
chai	ch:ai:|S:E:	1
comptent	co:mp:tent|k:§:t	1
frise	fr:i:se|fR:i:z	1
puaient	pu:aient:|p8:E:	1
crampes	cr:am:pes|kR:@:p	1
proze	pr:oz:e|pR:o:z	1
flattent	fla:t:tent|fl:a:t	1
sigles	s:i:gles|s:i:gl	1
soute	s:ou:te|s:u:t	1
tigre	t:i:gre|t:i:gR	1
saintes	sa:in:tes|s:5:t	1
dû	d:û:|d:y:	1
tua	tu:a:|t8:a:	1
scandent	sc:an:dent|sk:@:d	1
sauf	s:au:f|s:o:f	1
yens	y:e:ns|j:E:n	1
fûmes	f:û:mes|f:y:m	1
smocks	sm:o:cks|sm:o:k	1
males	m:a:les|m:a:l	1
trinquent	tr:in:quent|tR:5:k	1
mâte	m:â:te|m:a:t	1
jules	j:u:les|Z:y:l	1
rôle	r:ô:le|R:o:l	1
vouaient	vou:aient:|vw:E:	1
louches	l:ou:ches|l:u:S	1
cois	coi:s:|kw:a:	1
raque	r:a:que|R:a:k	1
fleuve	fl:eu:ve|fl:9:v	1
dense	d:en:se|d:@:s	1
jappent	j:a:ppent|Z:a:p	1
moindre	mo:in:dre|mw:5:dR	1
gratte	gr:at:te|gR:a:t	1
co	c:o:|k:o:	1
prône	pr:ô:ne|pR:o:n	1
barbes	b:a:rbes|b:a:Rb	1
serpes	s:e:rpes|s:E:Rp	1
cuivre	cu:i:vre|k8:i:vR	1
tends	t:ends:|t:@:	1
cuit	cui:t:|k8:i:	1
vibre	v:i:bre|v:i:bR	1
eusses	:eu:sses|:y:s	1
branches	br:an:ches|bR:@:S	1
shift	sh:i:ft|S:i:ft	1
poix	poi:x:|pw:a:	1
vierge	vi:e:rge|vj:E:RZ	1
daces	d:a:ces|d:a:s	1
stricts	str:i:cts|stR:i:kt	1
liait	li:ait:|lj:E:	1
aiment	:ai:ment|:E:m	1
flac	fl:a:c|fl:a:k	1
cries	cr:ies:|kR:i:	1
angles	:an:gles|:@:gl	1
ambre	:a:mbre|:@:bR	1
cassent	c:a:ssent|k:a:s	1
chaux	ch:aux:|S:o:	1
liards	li:a:rds|lj:a:R	1
caque	c:a:que|k:a:k	1
rué	ru:é:|R8:e:	1
fors	f:or:s|f:O:R	1
mûrs	m:ûr:s|m:y:R	1
moise	moi:s:e|mw:a:z	1
soles	s:o:les|s:O:l	1
craquent	cr:a:quent|kR:a:k	1
crame	cr:a:me|kR:a:m	1
cale	c:a:le|k:a:l	1
vote	v:o:te|v:O:t	1
bouif	bou:i:f|bw:i:f	1
barbe	b:a:rbe|b:a:Rb	1
pogne	p:o:gne|p:O:N	1
encres	:en:cres|:@:kR	1
voir	vo:i:r|vw:a:R	1
marquent	m:a:rquent|m:a:Rk	1
traîtres	tr:aî:tres|tR:E:tR	1
aîtres	:aî:tres|:E:tR	1
strate	str:a:te|stR:a:t	1
jase	j:a:se|Z:a:z	1
laites	l:ai:tes|l:E:t	1
glaises	gl:ai:ses|gl:E:z	1
chips	ch:i:ps|S:i:ps	1
usent	:u:sent|:y:z	1
fanges	f:an:ges|f:@:Z	1
dogmes	d:o:gmes|d:O:gm	1
gaz	g:a:z|g:a:z	1
cèdres	c:è:dres|s:E:dR	1
traces	tr:a:ces|tR:a:s	1
froids	froi:ds:|fRw:a:	1
scrubs	scr:u:bs|skR:9:b	1
heures	:heu:res|:9:R	1
trot	tr:ot:|tR:o:	1
slave	sl:a:ve|sl:a:v	1
dôngs	d:ôn:gs|d:§:g	1
tombe	t:om:be|t:§:b	1
coq	c:o:q|k:O:k	1
sait	s:ait:|s:E:	1
sus	s:u:s|s:y:s	1
hare	:ha:re|:a:R	1
brossent	br:o:ssent|bR:O:s	1
riez	rie:z:|Rj:e:	1
câpre	c:â:pre|k:a:pR	1
oins	o:ins:|w:5:	1
pose	p:o:se|p:o:z	1
nos	no:s:|n:o:	1
pouacre	pou:a:cre|pw:a:kR	1
clos	cl:os:|kl:o:	1
plèbe	pl:è:be|pl:E:b	1
cotte	co:t:te|k:O:t	1
joie	joi:e:|Zw:a:	1
herses	:he:rses|:E:Rs	1
tocs	t:o:cs|t:O:k	1
trous	tr:ous:|tR:u:	1
lav	l:a:v|l:a:v	1
chiasses	chi:a:sses|Sj:a:s	1
bat	b:at:|b:a:	1
fane	f:a:ne|f:a:n	1
myope	my:o:pe|mj:O:p	1
joices	joi:c:es|Zw:a:s	1
nées	n:ées:|n:e:	1
filmes	f:i:lmes|f:i:lm	1
vices	v:i:ces|v:i:s	1
vaines	v:ai:nes|v:E:n	1
zone	z:o:ne|z:o:n	1
tables	t:a:bles|t:a:bl	1
ouate	ou:a:te|w:a:t	1
haires	:hai:res|:E:R	1
mile	m:i:le|m:a:jl	1
taches	t:a:ches|t:a:S	1
louée	lou:ée:|lw:e:	1
pendent	p:en:dent|p:@:d	1
nouais	nou:ais:|nw:E:	1
brune	br:u:ne|bR:y:n	1
mères	m:è:res|m:E:R	1
fiat	fi:a:t|fj:a:t	1
vrac	vr:a:c|vR:a:k	1
girls	g:i:rls|g:9:Rl	1
bittes	b:it:tes|b:i:t	1
viandes	vi:an:des|vj:@:d	1
quarts	qu:a:rts|k:a:R	1
bille	b:i:lle|b:i:j	1
prônes	pr:ô:nes|pR:o:n	1
turques	t:u:rques|t:y:Rk	1
cintres	c:in:tres|s:5:tR	1
grumes	gr:u:mes|gR:y:m	1
couac	cou:a:c|kw:a:k	1
mi	m:i:|m:i:	1
brunes	br:u:nes|bR:y:n	1
tâte	t:â:te|t:a:t	1
lifts	l:i:fts|l:i:f	1
pestes	p:e:stes|p:E:st	1
prennent	pr:en:nent|pR:E:n	1
orgues	:o:rgues|:O:Rg	1
closent	cl:o:sent|kl:o:z	1
proie	proi:e:|pRw:a:	1
graisse	gr:ai:sse|gR:E:s	1
mouftes	m:ou:ftes|m:u:ft	1
trigles	tr:i:gles|tR:i:gl	1
kitsch	k:i:tsch|k:i:tS	1
sniffe	sn:i:ffe|sn:i:f	1
comble	co:m:ble|k:§:bl	1
tendent	t:en:dent|t:@:d	1
trouent	tr:ouent:|tR:u:	1
fourguent	f:ou:rguent|f:u:Rg	1
sciait	sci:ait:|sj:E:	1
hausse	:hau:sse|:o:s	1
vises	v:i:ses|v:i:z	1
perme	p:e:rme|p:E:Rm	1
proues	pr:oues:|pR:u:	1
prêles	pr:ê:les|pR:E:l	1
quelques	qu:e:lques|k:E:lk	1
ures	:u:res|:y:R	1
vraie	vr:aie:|vR:E:	1
pin	p:in:|p:5:	1
page	p:a:ge|p:a:Z	1
propre	pr:o:pre|pR:O:pR	1
mordes	m:o:rdes|m:O:Rd	1
niés	ni:és:|nj:e:	1
cloches	cl:o:ches|kl:O:S	1
crac	cr:a:c|kR:a:k	1
schproum	schpr:ou:m|spR:u:m	1
piastres	pi:a:stres|pj:a:stR	1
break	br:e:ak|bR:E:k	1
cotre	c:o:tre|k:O:tR	1
telles	t:el:les|t:E:l	1
bardes	b:a:rdes|b:a:Rd	1
frêle	fr:ê:le|fR:E:l	1
charte	ch:a:rte|S:a:Rt	1
gaffe	g:a:ffe|g:a:f	1
ment	m:ent:|m:@:	1
montes	m:on:tes|m:§:t	1
boute	b:ou:te|b:u:t	1
tonte	t:on:te|t:§:t	1
frics	fr:i:cs|fR:i:k	1
louons	lou:ons:|lw:§:	1
jonc	jo:nc:|Z:§:	1
rage	r:a:ge|R:a:Z	1
schleu	schl:eu:|Sl:2:	1
raide	r:ai:de|R:E:d	1
tanne	t:a:nne|t:a:n	1
niquent	n:i:quent|n:i:k	1
gail	g:ai:l|g:E:l	1
lloyd	l:lo:yd|l:O:jd	1
source	s:ou:rce|s:u:Rs	1
glanes	gl:a:nes|gl:a:n	1
blindes	bl:in:des|bl:5:d	1
sprays	spr:a:ys|spR:E:j	1
maîtres	ma:î:tres|m:E:tR	1
minces	m:in:ces|m:5:s	1
chancres	ch:an:cres|S:@:kR	1
trompent	tr:om:pent|tR:§:p	1
goal	go:a:l|g:o:l	1
feintes	fe:in:tes|f:5:t	1
perte	p:e:rte|p:E:Rt	1
pactes	p:a:ctes|p:a:kt	1
bouc	b:ou:c|b:u:k	1
cire	c:i:re|s:i:R	1
urf	:u:rf|:y:Rf	1
gouet	gou:et:|gw:E:	1
truites	tru:i:tes|tR8:i:t	1
fleurs	fl:eur:s|fl:9:R	1
meule	m:eu:le|m:2:l	1
shootent	sho:o:tent|S:u:t	1
nues	n:ues:|n:y:	1
lits	l:its:|l:i:	1
porcs	p:or:cs|p:O:R	1
scoops	sc:o:ops|sk:u:p	1
compte	co:mp:te|k:§:t	1
houppe	:houp:pe|:u:p	1
ruai	ru:ai:|R8:E:	1
daine	d:ai:ne|d:E:n	1
ouaille	ou:a:ille|w:a:j	1
joint	joi:nt:|Zw:5:	1
spa	sp:a:|sp:a:	1
testent	t:e:stent|t:E:st	1
dînent	d:î:nent|d:i:n	1
daigne	d:ai:gne|d:E:N	1
jouées	jou:ées:|Zw:e:	1
roule	r:ou:le|R:u:l	1
plum	pl:u:m|pl:u:m	1
chausse	ch:au:sse|S:o:s	1
bercent	b:e:rcent|b:E:Rs	1
brout	br:out:|bR:u:	1
hop	:ho:p|:O:p	1
spi	sp:i:|sp:i:	1
vente	v:en:te|v:@:t	1
jacks	j:a:cks|Z:a:k	1
traîne	tr:aî:ne|tR:E:n	1
restes	r:e:stes|R:E:st	1
flanchent	fl:an:chent|fl:@:S	1
fée	f:ée:|f:e:	1
stretch	str:e:tch|stR:E:tS	1
flamme	fla:m:me|fl:a:m	1
sombrent	s:om:brent|s:§:bR	1
kiosques	ki:o:sques|kj:O:sk	1
volte	v:o:lte|v:O:lt	1
bottes	b:ot:tes|b:O:t	1
flou	fl:ou:|fl:u:	1
schlingues	schl:in:gues|Sl:5:g	1
flasque	fl:a:sque|fl:a:sk	1
scieur	sci:eu:r|sj:9:R	1
mures	m:u:res|m:y:R	1
prompts	pr:ompts:|pR:§:	1
ouït	ouï:t:|w:i:	1
choit	choi:t:|Sw:a:	1
gonfles	g:on:fles|g:§:fl	1
truck	tr:u:ck|tR:y:k	1
bic	b:i:c|b:i:k	1
migre	m:i:gre|m:i:gR	1
once	:on:ce|:§:s	1
té	t:é:|t:e:	1
zoom	zo:o:m|z:u:m	1
mouille	m:ou:ille|m:u:j	1
crosne	cr:o:sne|kR:O:sn	1
paître	p:aî:tre|p:E:tR	1
fauves	f:au:ves|f:o:v	1
tressent	tr:e:ssent|tR:E:s	1
râpes	r:â:pes|R:a:p	1
coque	c:o:que|k:O:k	1
puis	pui:s:|p8:i:	1
bus	b:us:|b:y:	1
lope	l:o:pe|l:O:p	1
fioul	fi:ou:l|fj:u:l	1
seine	s:e:ine|s:E:n	1
nase	n:a:se|n:a:z	1
livre	l:i:vre|l:i:vR	1
tweed	twe:e:d|tw:i:d	1
vouait	vou:ait:|vw:E:	1
ourle	:ou:rle|:u:Rl	1
lame	l:a:me|l:a:m	1
criques	cr:i:ques|kR:i:k	1
mouds	mo:uds:|m:u:	1
fâches	f:â:ches|f:a:S	1
vouivres	vou:i:vres|vw:i:vR	1
laques	l:a:ques|l:a:k	1
stères	st:è:res|st:E:R	1
huèrent	hu:è:rent|8:E:R	1
chèches	ch:è:ches|S:E:S	1
skie	sk:ie:|sk:i:	1
scribes	scr:i:bes|skR:i:b	1
mânes	m:â:nes|m:a:n	1
mas	ma:s:|m:a:	1
loupe	l:ou:pe|l:u:p	1
bortch	b:o:rtch|b:O:RtS	1
princes	pr:in:ces|pR:5:s	1
naze	n:a:ze|n:a:z	1
joueurs	jou:eur:s|Zw:9:R	1
dresse	dr:e:sse|dR:E:s	1
ire	:i:re|:i:R	1
jouâmes	jou:â:mes|Zw:a:m	1
choeurs	c:ho:eurs|k:9:R	1
gosse	g:o:sse|g:O:s	1
salles	s:al:les|s:a:l	1
saouls	s:aouls:|s:u:	1
pigne	p:i:gne|p:i:N	1
camphre	c:amp:hre|k:@:fR	1
purges	p:u:rges|p:y:RZ	1
des	d:es:|d:e:	1
coachs	co:a:chs|k:o:tS	1
rac	r:a:c|R:a:k	1
piastre	pi:a:stre|pj:a:stR	1
couche	c:ou:che|k:u:S	1
chelem	chel:e:m|Sl:E:m	1
punk	p:un:k|p:1:k	1
sample	s:am:ple|s:@:pl	1
asthme	:a:sthme|:a:sm	1
chances	ch:an:ces|S:@:s	1
trocs	tr:o:cs|tR:O:k	1
jade	j:a:de|Z:a:d	1
champ'	ch:amp:'|S:@:p	1
acre	:a:cre|:a:kR	1
grange	gr:an:ge|gR:@:Z	1
sicle	s:i:cle|s:i:kl	1
black	bl:a:ck|bl:a:k	1
sketches	sk:e:tches|sk:E:tS	1
foutent	f:ou:tent|f:u:t	1
fluides	flu:i:des|fl8:i:d	1
peps	p:e:ps|p:E:ps	1
pupe	p:u:pe|p:y:p	1
maure	m:au:re|m:o:R	1
sols	s:o:ls|s:O:l	1
tzar	tz:a:r|ts:a:R	1
pente	p:en:te|p:@:t	1
moudre	m:ou:dre|m:u:dR	1
feignent	f:e:ignent|f:E:N	1
top	t:o:p|t:O:p	1
vendre	v:en:dre|v:@:dR	1
grute	gr:u:te|gR:y:t	1
plates	pl:a:tes|pl:a:t	1
dé	d:é:|d:e:	1
fiel	fi:e:l|fj:E:l	1
dose	d:o:se|d:o:z	1
igues	:i:gues|:i:g	1
coches	c:o:ches|k:O:S	1
justes	j:u:stes|Z:y:st	1
haies	:haies:|:E:	1
tours	t:ou:rs|t:u:R	1
suants	su:ants:|s8:@:	1
choke	ch:o:ke|S:O:k	1
gluent	gl:uent:|gl:y:	1
glèbe	gl:è:be|gl:E:b	1
rendre	r:en:dre|R:@:dR	1
rhumes	r:hu:mes|R:y:m	1
crocs	cr:ocs:|kR:o:	1
eu	:eu:|:y:	1
gonze	g:on:ze|g:§:z	1
gauches	g:au:ches|g:o:S	1
bey	b:ey:|b:E:	1
peurs	p:eur:s|p:9:R	1
groups	gr:ou:ps|gR:u:p	1
vroum	vr:ou:m|vR:u:m	1
bris	br:is:|bR:i:	1
floues	fl:oues:|fl:u:	1
pas	p:as:|p:a:	1
chanvre	ch:an:vre|S:@:vR	1
lares	l:a:res|l:a:R	1
barques	b:a:rques|b:a:Rk	1
close	cl:o:se|kl:o:z	1
moufte	m:ou:fte|m:u:ft	1
rendent	r:en:dent|R:@:d	1
roches	r:o:ches|R:O:S	1
cade	c:a:de|k:a:d	1
rende	r:en:de|R:@:d	1
flûtes	fl:û:tes|fl:y:t	1
fonde	f:on:de|f:§:d	1
code	c:o:de|k:O:d	1
fixent	f:i:xent|f:i:ks	1
rouilles	r:ou:illes|R:u:j	1
l'une	l:'u:ne|l:y:n	1
rad	r:a:d|R:a:d	1
violes	vi:o:les|vj:O:l	1
faine	f:ai:ne|f:E:n	1
croire	cro:i:re|kRw:a:R	1
packs	p:a:cks|p:a:k	1
pauvre	p:au:vre|p:o:vR	1
citent	c:i:tent|s:i:t	1
urge	:u:rge|:y:RZ	1
lace	l:a:ce|l:a:s	1
joueuses	jou:eu:ses|Zw:2:z	1
fouaces	fou:a:ces|fw:a:s	1
verve	v:e:rve|v:E:Rv	1
maze	m:a:ze|m:a:z	1
spleen	spl:e:en|spl:i:n	1
selfs	s:e:lfs|s:E:lf	1
mèches	m:è:ches|m:E:S	1
dos	do:s:|d:o:	1
morne	m:o:rne|m:O:Rn	1
mec	m:e:c|m:E:k	1
noires	no:i:res|nw:a:R	1
courts	c:ou:rts|k:u:R	1
cernent	c:e:rnent|s:E:Rn	1
focs	f:o:cs|f:O:k	1
chat	ch:at:|S:a:	1
laie	l:aie:|l:E:	1
mué	mu:é:|m8:e:	1
gangue	g:an:gue|g:@:g	1
drilles	dr:i:lles|dR:i:j	1
pitre	p:i:tre|p:i:tR	1
semblent	s:e:mblent|s:@:bl	1
dam	d:am:|d:@:	1
pins	p:ins:|p:5:	1
quitte	qu:it:te|k:i:t	1
deal	d:e:al|d:i:l	1
shoote	sho:o:te|S:u:t	1
raille	r:a:ille|R:a:j	1
bonde	b:on:de|b:§:d	1
fiente	fie:n:te|fj:@:t	1
souches	s:ou:ches|s:u:S	1
naines	n:ai:nes|n:E:n	1
khôl	k:hô:l|k:o:l	1
maître	ma:î:tre|m:E:tR	1
tchatche	tch:a:tche|tS:a:tS	1
bled	bl:e:d|bl:E:d	1
bans	b:ans:|b:@:	1
noueux	nou:eux:|nw:2:	1
deck	d:e:ck|d:E:k	1
drus	dr:us:|dR:y:	1
stricte	str:i:cte|stR:i:kt	1
lentes	l:en:tes|l:@:t	1
calles	c:al:les|k:a:l	1
foot	fo:o:t|f:u:t	1
sou	s:ou:|s:u:	1
stagnent	st:a:gnent|st:a:gn	1
je	j:e:|Z:2:	1
brûlent	br:û:lent|bR:y:l	1
rink	r:i:nk|R:i:nk	1
fruit	frui:t:|fR8:i:	1
logue	l:o:gue|l:O:g	1
rincent	r:inc:ent|R:5:s	1
cons	co:ns:|k:§:	1
rise	r:i:se|R:i:z	1
suc	s:u:c|s:y:k	1
baignes	b:ai:gnes|b:E:N	1
blondes	bl:on:des|bl:§:d	1
pull	p:ul:l|p:y:l	1
froides	fro:i:des|fRw:a:d	1
ruinent	ru:i:nent|R8:i:n	1
hits	:hit:s|:i:t	1
oeuf	:oe:uf|:9:f	1
labbes	l:a:bbes|l:a:b	1
camps	c:amps:|k:@:	1
blot	bl:ot:|bl:o:	1
mimes	m:i:mes|m:i:m	1
freux	fr:eux:|fR:2:	1
drôles	dr:ô:les|dR:o:l	1
chute	ch:u:te|S:y:t	1
voles	v:o:les|v:O:l	1
chas	ch:as:|S:a:	1
texte	t:e:xte|t:E:kst	1
missent	m:i:ssent|m:i:s	1
pincent	p:inc:ent|p:5:s	1
lassent	l:a:ssent|l:a:s	1
jobs	jo:b:s|dZ:O:b	1
badges	b:a:dges|b:a:dZ	1
fraie	fr:aie:|fR:E:	1
com	c:o:m|k:O:m	1
prît	pr:ît:|pR:i:	1
gonflent	g:on:flent|g:§:fl	1
ruines	ru:i:nes|R8:i:n	1
suives	su:i:ves|s8:i:v	1
patches	p:a:tches|p:a:tS	1
magnent	m:a:gnent|m:a:N	1
flush	fl:us:h|fl:9:S	1
bitent	b:i:tent|b:i:t	1
âmes	:â:mes|:a:m	1
khan	kh:a:n|k:a:n	1
gui	g:ui:|g:i:	1
dèches	d:è:ches|d:E:S	1
tonds	t:onds:|t:§:	1
clauses	cl:au:ses|kl:o:z	1
fonce	f:on:ce|f:§:s	1
iodle	i:o:dle|j:o:dl	1
hottes	:hot:tes|:O:t	1
doux	d:oux:|d:u:	1
faon	f:aon:|f:@:	1
jauge	j:au:ge|Z:o:Z	1
set	s:e:t|s:E:t	1
triment	tr:i:ment|tR:i:m	1
crèchent	cr:è:chent|kR:E:S	1
nette	ne:t:te|n:E:t	1
lois	loi:s:|lw:a:	1
hic	:hi:c|:i:k	1
valves	v:a:lves|v:a:lv	1
couinent	cou:i:nent|kw:i:n	1
biques	b:i:ques|b:i:k	1
boches	b:o:ches|b:O:S	1
bermes	b:e:rmes|b:E:Rm	1
actes	:a:ctes|:a:kt	1
bold	b:o:ld|b:O:ld	1
solde	s:o:lde|s:O:ld	1
toi	to:i:|tw:a:	1
rouait	rou:ait:|Rw:E:	1
web	w:e:b|w:E:b	1
glauques	gl:au:ques|gl:o:k	1
ohms	:ohm:s|:o:m	1
cuistres	cu:i:stres|k8:i:stR	1
veld	v:e:ld|v:E:ld	1
druide	dru:i:de|dR8:i:d	1
crusse	cr:u:sse|kR:y:s	1
fol	f:o:l|f:O:l	1
broc	br:oc:|bR:o:	1
french	fr:e:nch|fR:E:nS	1
biens	bie:ns:|bj:5:	1
marques	m:a:rques|m:a:Rk	1
tangue	t:an:gue|t:@:g	1
parce	p:a:rce|p:a:Rs	1
tend	t:end:|t:@:	1
goûtent	g:oû:tent|g:u:t	1
crouille	cr:ou:ille|kR:u:j	1
dièdres	di:è:dres|dj:E:dR	1
goths	g:oths:|g:o:	1
pets	p:ets:|p:E:	1
chypre	ch:y:pre|S:i:pR	1
scone	sc:o:ne|sk:o:n	1
gloires	glo:i:res|glw:a:R	1
in	:i:n|:i:n	1
nom	no:m:|n:§:	1
gilles	g:il:les|Z:i:l	1
boives	bo:i:ves|bw:a:v	1
genres	g:en:res|Z:@:R	1
vîmes	v:î:mes|v:i:m	1
gnomes	gn:o:mes|gn:o:m	1
gueuse	g:ueu:se|g:2:z	1
tuât	tu:ât:|t8:a:	1
globe	gl:o:be|gl:O:b	1
ponces	p:on:ces|p:§:s	1
bigne	b:i:gne|b:i:N	1
pommes	p:om:mes|p:O:m	1
rosses	r:o:sses|R:O:s	1
bains	b:ains:|b:5:	1
rocs	r:o:cs|R:O:k	1
brayes	br:ay:es|bR:E:j	1
poivres	po:i:vres|pw:a:vR	1
tierce	ti:e:rce|tj:E:Rs	1
gonds	g:onds:|g:§:	1
corne	c:o:rne|k:O:Rn	1
floc	fl:o:c|fl:O:k	1
nant	n:ant:|n:@:	1
fuis	fui:s:|f8:i:	1
nombre	n:om:bre|n:§:bR	1
tomes	t:o:mes|t:O:m	1
sasse	s:a:sse|s:a:s	1
braises	br:ai:ses|bR:E:z	1
hune	:hu:ne|:y:n	1
tombes	t:om:bes|t:§:b	1
massent	m:a:ssent|m:a:s	1
rhumbs	r:hum:bs|R:§:b	1
bulle	b:ul:le|b:y:l	1
dynes	d:y:nes|d:i:n	1
chia	chi:a:|Sj:a:	1
laisses	l:ai:sses|l:E:s	1
mouche	m:ou:che|m:u:S	1
sens	s:ens:|s:@:	1
cesses	c:e:sses|s:E:s	1
crût	cr:ût:|kR:y:	1
vamp	v:am:p|v:@:p	1
rances	r:an:ces|R:@:s	1
quette	que:t:te|k:E:t	1
luire	lu:i:re|l8:i:R	1
ska	sk:a:|sk:a:	1
verses	v:e:rses|v:E:Rs	1
tests	t:es:ts|t:E:st	1
crise	cr:i:se|kR:i:z	1
spics	sp:i:cs|sp:i:k	1
buts	b:ut:s|b:y:t	1
hi	:hi:|:i:	1
sapent	s:a:pent|s:a:p	1
briquent	br:i:quent|bR:i:k	1
plante	pl:an:te|pl:@:t	1
sondes	s:on:des|s:§:d	1
cailles	c:a:illes|k:a:j	1
cloquent	cl:o:quent|kl:O:k	1
roll	r:o:ll|R:O:l	1
cirques	c:i:rques|s:i:Rk	1
gniouf	gni:ou:f|N:u:f	1
valve	v:a:lve|v:a:lv	1
jans	j:ans:|Z:@:	1
terre	t:er:re|t:E:R	1
flaques	fl:a:ques|fl:a:k	1
bore	b:o:re|b:O:R	1
frite	fr:i:te|fR:i:t	1
scieurs	sci:eur:s|sj:9:R	1
bâfre	b:â:fre|b:a:fR	1
ciste	c:i:ste|s:i:st	1
gnome	gn:o:me|gn:o:m	1
chouette	chou:et:te|Sw:E:t	1
duel	du:e:l|d8:E:l	1
phi	ph:i:|f:i:	1
semble	s:e:mble|s:@:bl	1
ronflent	r:on:flent|R:§:fl	1
titres	t:i:tres|t:i:tR	1
prêts	pr:êts:|pR:E:	1
louche	l:ou:che|l:u:S	1
naine	n:ai:ne|n:E:n	1
largues	l:a:rgues|l:a:Rg	1
face	f:a:ce|f:a:s	1
preuves	pr:eu:ves|pR:9:v	1
ron	r:on:|R:§:	1
rares	r:a:res|R:a:R	1
dons	d:ons:|d:§:	1
dupes	d:u:pes|d:y:p	1
gaffent	g:a:ffent|g:a:f	1
fleuves	fl:eu:ves|fl:9:v	1
cloque	cl:o:que|kl:O:k	1
bons	b:ons:|b:§:	1
doutent	d:ou:tent|d:u:t	1
buses	b:u:ses|b:y:z	1
nier	nie:r:|nj:e:	1
cuire	cu:i:re|k8:i:R	1
paie	p:aie:|p:E:	1
lippes	l:i:ppes|l:i:p	1
mioche	mi:o:che|mj:O:S	1
fripe	fr:i:pe|fR:i:p	1
vieux	vie:ux:|vj:2:	1
parthes	p:a:rthes|p:a:Rt	1
bouges	b:ou:ges|b:u:Z	1
scones	sc:o:nes|sk:o:n	1
leurrent	l:eur:rent|l:9:R	1
ô	:ô:|:o:	1
râpent	r:â:pent|R:a:p	1
croît	cro:ît:|kRw:a:	1
flanque	fl:an:que|fl:@:k	1
pailles	p:a:illes|p:a:j	1
by	b:y:|b:i:	1
chtouille	cht:ou:ille|St:u:j	1
pleurs	pl:eur:s|pl:9:R	1
clins	cl:ins:|kl:5:	1
rudes	r:u:des|R:y:d	1
fillér	fi:llé:r|fj:e:R	1
glasses	gl:a:sses|gl:a:s	1
scrub	scr:u:b|skR:O:b	1
glue	gl:ue:|gl:y:	1
nerf	n:e:rf|n:E:R	1
migres	m:i:gres|m:i:gR	1
morves	m:o:rves|m:O:Rv	1
rash	r:a:sh|R:a:S	1
craigne	cr:ai:gne|kR:E:N	1
stores	st:o:res|st:O:R	1
aître	:aî:tre|:E:tR	1
coupe	c:ou:pe|k:u:p	1
arbre	:a:rbre|:a:RbR	1
perd	p:e:rd|p:E:R	1
marne	m:a:rne|m:a:Rn	1
lorgne	l:o:rgne|l:O:RN	1
pua	pu:a:|p8:a:	1
brus	br:us:|bR:y:	1
purs	p:ur:s|p:y:R	1
grade	gr:a:de|gR:a:d	1
pieu	pie:u:|pj:2:	1
serines	se:ri:nes|sR:i:n	1
elle	:el:le|:E:l	1
faons	f:aons:|f:@:	1
trèpe	tr:è:pe|tR:E:p	1
palme	p:a:lme|p:a:lm	1
pines	p:i:nes|p:i:n	1
plinthes	pl:inth:es|pl:5:t	1
tète	t:è:te|t:E:t	1
fut	f:ut:|f:y:	1
gode	g:o:de|g:O:d	1
burnes	b:u:rnes|b:y:Rn	1
truffes	tr:u:ffes|tR:y:f	1
drame	dr:a:me|dR:a:m	1
grume	gr:u:me|gR:y:m	1
miettes	mie:t:tes|mj:E:t	1
claim	cl:ai:m|kl:E:m	1
trou	tr:ou:|tR:u:	1
sport	sp:or:t|sp:O:R	1
rond	r:ond:|R:§:	1
clerc	cl:e:rc|kl:E:R	1
vengent	v:en:gent|v:@:Z	1
pires	p:i:res|p:i:R	1
dock	d:o:ck|d:O:k	1
peinte	pe:in:te|p:5:t	1
faims	f:aims:|f:5:	1
dace	d:a:ce|d:a:s	1
crosses	cr:o:sses|kR:O:s	1
blush	bl:us:h|bl:9:S	1
calques	c:a:lques|k:a:lk	1
clilles	cl:il:les|kl:i:l	1
drague	dr:a:gue|dR:a:g	1
swings	sw:i:ngs|sw:i:G	1
brime	br:i:me|bR:i:m	1
penche	p:en:che|p:@:S	1
vient	vie:nt:|vj:5:	1
axent	:a:xent|:a:ks	1
lob	l:o:b|l:O:b	1
pâtes	p:â:tes|p:a:t	1
captent	c:a:ptent|k:a:pt	1
stem	st:e:m|st:E:m	1
touches	t:ou:ches|t:u:S	1
faxe	f:a:xe|f:a:ks	1
puissent	pu:i:ssent|p8:i:s	1
gais	g:ais:|g:e:	1
gendre	g:en:dre|Z:@:dR	1
fuie	fui:e:|f8:i:	1
claude	cl:au:de|kl:o:d	1
siennes	si:en:nes|sj:E:n	1
fritz	fr:i:tz|fR:i:ts	1
gale	g:a:le|g:a:l	1
scande	sc:an:de|sk:@:d	1
quel	qu:e:l|k:E:l	1
punt	p:u:nt|p:u:nt	1
nonnes	no:n:nes|n:O:n	1
posent	p:o:sent|p:o:z	1
piaffes	pi:a:ffes|pj:a:f	1
même	m:ê:me|m:E:m	1
grosses	gr:o:sses|gR:o:s	1
gèlent	g:è:lent|Z:E:l	1
hyènes	hy:è:nes|j:E:n	1
asse	:a:sse|:a:s	1
lippe	l:i:ppe|l:i:p	1
flirts	fl:i:rts|fl:9:Rt	1
chartre	ch:a:rtre|S:a:RtR	1
are	:a:re|:a:R	1
passe	p:a:sse|p:a:s	1
trouble	tr:ou:ble|tR:u:bl	1
iules	i:u:les|j:y:l	1
serais	ser:ais:|sR:E:	1
hyène	hy:è:ne|j:E:n	1
glop	gl:o:p|gl:O:p	1
tubs	t:u:bs|t:9:b	1
soient	soi:ent:|sw:a:	1
kitch	k:i:tch|k:i:tS	1
thèmes	t:hè:mes|t:E:m	1
berges	b:e:rges|b:E:RZ	1
couches	c:ou:ches|k:u:S	1
beurres	b:eur:res|b:9:R	1
flashs	fl:a:shs|fl:a:S	1
mouches	m:ou:ches|m:u:S	1
snobent	sn:o:bent|sn:O:b	1
pigent	p:i:gent|p:i:Z	1
clean	cl:e:an|kl:i:n	1
prout	pr:ou:t|pR:u:t	1
grill	gr:i:ll|gR:i:l	1
patch	p:a:tch|p:a:tS	1
hotte	:hot:te|:O:t	1
kiosk	ki:o:sk|kj:O:sk	1
martre	m:a:rtre|m:a:RtR	1
tine	t:i:ne|t:i:n	1
huée	h:uée:|8:e:	1
chutes	ch:u:tes|S:y:t	1
goûtes	g:oû:tes|g:u:t	1
poussent	p:ou:ssent|p:u:s	1
fine	f:i:ne|f:i:n	1
langues	l:an:gues|l:@:g	1
châtrent	ch:â:trent|S:a:tR	1
thèses	t:hè:ses|t:E:z	1
ors	:or:s|:O:R	1
hurlent	:hu:rlent|:y:Rl	1
mords	m:o:rds|m:O:R	1
largue	l:a:rgue|l:a:Rg	1
post	p:o:st|p:O:st	1
saoules	sa:ou:les|s:u:l	1
rince	r:in:ce|R:5:s	1
fixes	f:i:xes|f:i:ks	1
loge	l:o:ge|l:O:Z	1
glaces	gl:a:ces|gl:a:s	1
lads	l:a:ds|l:a:d	1
booms	b:o:oms|b:u:m	1
tasse	t:a:sse|t:a:s	1
foin	foi:n:|fw:5:	1
piaye	pi:a:ye|pj:a:j	1
menthe	m:ent:he|m:@:t	1
seps	s:e:ps|s:E:ps	1
chieuses	chie:u:ses|Sj:2:z	1
drogues	dr:o:gues|dR:O:g	1
golfe	g:o:lfe|g:O:lf	1
règnes	r:è:gnes|R:E:N	1
planques	pl:an:ques|pl:@:k	1
cognes	c:o:gnes|k:O:N	1
fonds	f:onds:|f:§:	1
fiole	fi:o:le|fj:O:l	1
mentent	m:en:tent|m:@:t	1
pore	p:o:re|p:O:R	1
pair	p:ai:r|p:E:R	1
suint	sui:nt:|s8:5:	1
lorsqu	l:o:rsqu|l:O:Rsk	1
gaffes	g:a:ffes|g:a:f	1
blâmes	bl:â:mes|bl:a:m	1
tousses	t:ou:sses|t:u:s	1
arquent	:a:rquent|:a:Rk	1
phrase	phr:a:se|fR:a:z	1
foire	fo:i:re|fw:a:R	1
chartes	ch:a:rtes|S:a:Rt	1
clash	cl:a:sh|kl:a:S	1
tardes	t:a:rdes|t:a:Rd	1
baht	b:a:ht|b:a:t	1
fion	fi:on:|fj:§:	1
puisses	pu:i:sses|p8:i:s	1
pa	p:a:|p:a:	1
zieutent	zie:u:tent|zj:2:t	1
pieutes	pie:u:tes|pj:2:t	1
mecs	m:e:cs|m:E:k	1
sphinges	sph:in:ges|sf:5:Z	1
suite	su:i:te|s8:i:t	1
jettent	j:et:tent|Z:E:t	1
botte	b:ot:te|b:O:t	1
drone	dr:o:ne|dR:o:n	1
flasques	fl:a:sques|fl:a:sk	1
hé	:hé:|:e:	1
gourds	g:ou:rds|g:u:R	1
fuient	fui:ent:|f8:i:	1
trace	tr:a:ce|tR:a:s	1
quilles	q:u:illes|k:i:j	1
dru	dr:u:|dR:y:	1
huche	:hu:che|:y:S	1
shale	sh:a:le|S:a:l	1
bibles	b:i:bles|b:i:bl	1
par	p:a:r|p:a:R	1
bricks	br:i:cks|bR:i:k	1
ries	r:ies:|R:i:	1
igue	:i:gue|:i:g	1
mame	m:a:me|m:a:m	1
bêches	b:ê:ches|b:E:S	1
parts	p:a:rts|p:a:R	1
tuas	tu:as:|t8:a:	1
thunes	t:hu:nes|t:y:n	1
belle	b:el:le|b:E:l	1
astres	:a:stres|:a:stR	1
liante	li:an:te|lj:@:t	1
kystes	k:y:stes|k:i:st	1
bruit	brui:t:|bR8:i:	1
trêve	tr:ê:ve|tR:E:v	1
nok	n:o:k|n:O:k	1
signe	s:i:gne|s:i:N	1
d'autres	d':au:tres|d:o:tR	1
violent	vi:o:lent|vj:O:l	1
canes	c:a:nes|k:a:n	1
lourd	l:ou:rd|l:u:R	1
thon	t:hon:|t:§:	1
blâment	bl:â:ment|bl:a:m	1
plat	pla:t:|pl:a:	1
con	c:on:|k:§:	1
calque	c:a:lque|k:a:lk	1
tuaient	tu:aient:|t8:E:	1
skates	sk:a:tes|sk:a:t	1
tueuses	tu:eu:ses|t8:2:z	1
viennes	vi:en:nes|vj:E:n	1
cors	c:or:s|k:O:R	1
trouille	tr:ou:ille|tR:u:j	1
scalpent	sc:a:lpent|sk:a:lp	1
baisses	b:ai:sses|b:E:s	1
poufs	p:ou:fs|p:u:f	1
skate	sk:a:te|sk:E:jt	1
muses	m:u:ses|m:y:z	1
rauques	r:au:ques|R:o:k	1
canche	c:an:che|k:@:S	1
placent	pla:c:ent|pl:a:s	1
livrent	l:i:vrent|l:i:vR	1
rasent	r:a:sent|R:a:z	1
bronches	br:on:ches|bR:§:S	1
fussent	f:u:ssent|f:y:s	1
vint	v:int:|v:5:	1
voeu	vo:eu:|v:2:	1
phase	ph:a:se|f:a:z	1
nuque	n:u:que|n:y:k	1
eaux	:eaux:|:o:	1
nus	n:us:|n:y:	1
comptes	co:mp:tes|k:§:t	1
chiasse	chi:a:sse|Sj:a:s	1
certes	c:e:rtes|s:E:Rt	1
voire	vo:i:re|vw:a:R	1
bluffe	bl:u:ffe|bl:9:f	1
chère	ch:è:re|S:E:R	1
mage	m:a:ge|m:a:Z	1
gouge	g:ou:ge|g:u:Z	1
charges	ch:a:rges|S:a:RZ	1
pourpre	p:ou:rpre|p:u:RpR	1
snobe	sn:o:be|sn:O:b	1
sen	s:e:n|s:E:n	1
bailes	b:ai:les|b:e:l	1
gemmes	ge:m:mes|Z:E:m	1
torches	t:o:rches|t:O:RS	1
nièces	nièc:e:s|nj:E:s	1
anses	:an:ses|:@:s	1
rame	r:a:me|R:a:m	1
rôdent	r:ô:dent|R:o:d	1
arc	:a:rc|:a:Rk	1
golfs	g:o:lfs|g:O:lf	1
percent	p:e:rcent|p:E:Rs	1
prèle	pr:è:le|pR:E:l	1
maigre	m:ai:gre|m:E:gR	1
grondes	gr:on:des|gR:§:d	1
buste	b:u:ste|b:y:st	1
fontes	f:on:tes|f:§:t	1
monde	m:on:de|m:§:d	1
ha	:ha:|:a:	1
cotes	c:o:tes|k:O:t	1
peints	p:eints:|p:5:	1
scirpe	sc:i:rpe|s:i:Rp	1
lard	l:a:rd|l:a:R	1
youp	y:ou:p|j:u:p	1
anges	:an:ges|:@:Z	1
rieur	ri:eu:r|Rj:9:R	1
faite	f:ai:te|f:E:t	1
soûlent	s:oû:lent|s:u:l	1
bleues	bl:eues:|bl:2:	1
lorsque	l:o:rsque|l:O:Rsk	1
star	st:a:r|st:a:R	1
scribe	scr:i:be|skR:i:b	1
bourbe	b:ou:rbe|b:u:Rb	1
arches	:a:rches|:a:RS	1
cous	cou:s:|k:u:	1
poutre	p:ou:tre|p:u:tR	1
vire	v:i:re|v:i:R	1
jas	j:as:|Z:a:	1
gril	gr:i:l|gR:i:l	1
pleuve	pl:eu:ve|pl:2:v	1
termes	t:e:rmes|t:E:Rm	1
frange	fr:an:ge|fR:@:Z	1
vrilles	vr:i:lles|vR:i:j	1
tourbe	t:ou:rbe|t:u:Rb	1
chasses	ch:a:sses|S:a:s	1
gloussent	gl:ou:ssent|gl:u:s	1
bleus	bl:eus:|bl:2:	1
vierges	vi:e:rges|vj:E:RZ	1
sciences	sci:en:ces|sj:@:s	1
codes	c:o:des|k:O:d	1
luths	l:uth:s|l:y:t	1
shit	sh:i:t|S:i:t	1
froisse	fro:i:sse|fRw:a:s	1
gringue	gr:in:gue|gR:5:g	1
brigues	br:i:gues|bR:i:g	1
mails	m:ai:ls|m:E:jl	1
croc	cr:oc:|kR:o:	1
globes	gl:o:bes|gl:O:b	1
types	t:y:pes|t:i:p	1
probes	pr:o:bes|pR:O:b	1
skins	sk:i:ns|sk:i:n	1
clouent	cl:ouent:|kl:u:	1
oints	o:ints:|w:5:	1
meublent	m:eu:blent|m:9:bl	1
fausses	f:au:sses|f:o:s	1
vêpre	v:ê:pre|v:E:pR	1
mores	m:o:res|m:O:R	1
yak	y:a:k|j:a:k	1
dates	d:a:tes|d:a:t	1
course	c:ou:rse|k:u:Rs	1
poignes	po:i:gnes|pw:a:N	1
frette	fr:et:te|fR:E:t	1
pussent	p:u:ssent|p:y:s	1
yole	y:o:le|j:O:l	1
jongles	j:on:gles|Z:§:gl	1
yack	y:a:ck|j:a:k	1
craies	cr:aies:|kR:E:	1
sole	s:o:le|s:O:l	1
pègre	p:è:gre|p:E:gR	1
raft	r:a:ft|R:a:ft	1
rif	r:i:f|R:i:f	1
limbe	li:m:be|l:5:b	1
surent	s:u:rent|s:y:R	1
brique	br:i:que|bR:i:k	1
chiots	chi:ots:|Sj:o:	1
soude	s:ou:de|s:u:d	1
brame	br:a:me|bR:a:m	1
taxent	t:a:xent|t:a:ks	1
changent	ch:an:gent|S:@:Z	1
dôme	d:ô:me|d:o:m	1
bugs	b:u:gs|b:9:gz	1
louf	l:ou:f|l:u:f	1
twists	tw:i:sts|tw:i:s	1
fond	f:ond:|f:§:	1
grasses	gr:a:sses|gR:a:s	1
phone	ph:o:ne|f:o:n	1
brode	br:o:de|bR:O:d	1
boots	bo:o:ts|b:u:ts	1
beiges	b:ei:ges|b:E:Z	1
rock	r:o:ck|R:O:k	1
vase	v:a:se|v:a:z	1
bill	b:i:ll|b:i:l	1
couille	c:ou:ille|k:u:j	1
au	:au:|:o:	1
moule	m:ou:le|m:u:l	1
garde	g:a:rde|g:a:Rd	1
trie	tr:ie:|tR:i:	1
joignent	jo:i:gnent|Zw:a:N	1
piètre	pi:è:tre|pj:E:tR	1
soufflent	s:ou:fflent|s:u:fl	1
mouettes	mou:et:tes|mw:E:t	1
scannes	sc:a:nnes|sk:a:n	1
pub	p:u:b|p:9:b	1
vouivre	vou:i:vre|vw:i:vR	1
fiord	fi:o:rd|fj:O:Rd	1
vis	v:i:s|v:i:s	1
huards	hu:a:rds|8:a:R	1
este	:e:ste|:E:st	1
drome	dr:o:me|dR:o:m	1
rhum	r:hu:m|R:O:m	1
bran	br:an:|bR:@:	1
lègue	l:è:gue|l:E:g	1
plectre	pl:e:ctre|pl:E:ktR	1
vanne	v:a:nne|v:a:n	1
plus	pl:u:s|pl:y:s	1
straight	str:aigh:t|stR:E:t	1
ruses	r:u:ses|R:y:z	1
laisse	l:ai:sse|l:E:s	1
beat	b:e:at|b:i:t	1
lissent	l:i:ssent|l:i:s	1
hyades	hy:a:des|j:a:d	1
brises	br:i:ses|bR:i:z	1
bipe	b:i:pe|b:i:p	1
gusse	g:u:sse|g:y:s	1
sourd	s:ou:rd|s:u:R	1
thons	t:hons:|t:§:	1
fiable	fi:a:ble|fj:a:bl	1
druze	dr:u:ze|dR:y:z	1
pat	p:a:t|p:a:t	1
gueules	gu:eu:les|g:9:l	1
joué	jou:é:|Zw:e:	1
règne	r:è:gne|R:E:N	1
huis	hu:is:|8:i:	1
crurent	cr:u:rent|kR:y:R	1
mir	m:i:r|m:i:R	1
bal	b:a:l|b:a:l	1
goals	g:oal:s|g:o:l	1
brèches	br:è:ches|bR:E:S	1
thraces	thr:a:ces|tR:a:s	1
joues	jou:es:|Z:u:	1
pieux	pie:ux:|pj:2:	1
cuve	c:u:ve|k:y:v	1
sauves	s:au:ves|s:o:v	1
sourds	s:ou:rds|s:u:R	1
pied	pie:d:|pj:e:	1
dits	d:its:|d:i:	1
vois	voi:s:|vw:a:	1
grands	gr:ands:|gR:@:	1
piaffe	pi:a:ffe|pj:a:f	1
trust	tr:u:st|tR:9:st	1
vif	v:i:f|v:i:f	1
caches	c:a:ches|k:a:S	1
diurne	di:u:rne|dj:y:Rn	1
liesses	li:e:sses|lj:E:s	1
serez	se:rez:|sR:e:	1
skiait	ski:ait:|skj:E:	1
flanche	fl:an:che|fl:@:S	1
pour	p:ou:r|p:u:R	1
claques	cl:a:ques|kl:a:k	1
pu	p:u:|p:y:	1
fuit	fui:t:|f8:i:	1
clamps	cla:mp:s|kl:@:p	1
guinche	gu:in:che|g:5:S	1
tisse	t:i:sse|t:i:s	1
scie	s:cie:|s:i:	1
grèves	gr:è:ves|gR:E:v	1
poivre	po:i:vre|pw:a:vR	1
pondre	p:on:dre|p:§:dR	1
sache	s:a:che|s:a:S	1
lei	l:ei:|l:E:	1
brident	br:i:dent|bR:i:d	1
tarses	t:a:rses|t:a:Rs	1
grues	gr:ues:|gR:y:	1
vlouf	vl:ou:f|vl:u:f	1
franque	fr:an:que|fR:@:k	1
tut	t:ut:|t:y:	1
pioncent	pi:onc:ent|pj:§:s	1
toises	toi:s:es|tw:a:z	1
vair	v:ai:r|v:E:R	1
triplent	tr:i:plent|tR:i:pl	1
gerce	g:e:rce|Z:E:Rs	1
mies	m:ies:|m:i:	1
folks	f:o:lks|f:O:lk	1
stocke	st:o:cke|st:O:k	1
rêve	r:ê:ve|R:E:v	1
fi	f:i:|f:i:	1
fung	f:u:ng|f:u:G	1
fières	fi:è:res|fj:E:R	1
prit	pr:it:|pR:i:	1
nuisent	nu:i:sent|n8:i:z	1
tiers	ti:e:rs|tj:E:R	1
très	tr:ès:|tR:E:	1
sic	s:i:c|s:i:k	1
crussent	cr:u:ssent|kR:y:s	1
vieil	vi:e:il|vj:E:j	1
marchent	m:a:rchent|m:a:RS	1
bâches	b:â:ches|b:a:S	1
tombent	t:ombe:nt|t:§:b	1
pion	pi:on:|pj:§:	1
joints	joi:nts:|Zw:5:	1
tank	t:an:k|t:@:k	1
trouves	tr:ou:ves|tR:u:v	1
gus	g:u:s|g:y:s	1
e	:e:|:2:	1
peigne	p:e:igne|p:E:N	1
braves	br:a:ves|bR:a:v	1
vaincre	va:in:cre|v:5:kR	1
gap	g:a:p|g:a:p	1
lunch	l:u:nch|l:9:ntS	1
verges	v:e:rges|v:E:RZ	1
baises	b:ai:ses|b:E:z	1
bombent	b:ombe:nt|b:§:b	1
sciant	sci:ant:|sj:@:	1
bancs	b:ancs:|b:@:	1
ptyx	pt:y:x|pt:i:ks	1
breaks	br:e:aks|bR:E:k	1
chie	ch:ie:|S:i:	1
vines	v:i:nes|v:i:n	1
saillent	s:a:illent|s:a:j	1
mouilles	m:ou:illes|m:u:j	1
if	:i:f|:i:f	1
vains	va:ins:|v:5:	1
luth	l:u:th|l:y:t	1
hâles	:hâ:les|:a:l	1
joindre	jo:in:dre|Zw:5:dR	1
noué	nou:é:|nw:e:	1
toge	t:o:ge|t:O:Z	1
mâts	m:âts:|m:a:	1
offrent	:o:ffrent|:O:fR	1
smack	sm:a:ck|sm:a:k	1
quine	qu:i:ne|k:i:n	1
lot	l:ot:|l:o:	1
couines	cou:i:nes|kw:i:n	1
filtre	f:i:ltre|f:i:ltR	1
blindent	bl:in:dent|bl:5:d	1
pet	p:et:|p:E:	1
sphinx	sph:in:x|sf:5:ks	1
croulent	cr:ou:lent|kR:u:l	1
voie	voi:e:|vw:a:	1
niée	ni:ée:|nj:e:	1
vielle	vie:l:le|vj:E:l	1
litres	l:i:tres|l:i:tR	1
ai	:ai:|:E:	1
joncs	jo:ncs:|Z:§:	1
meurent	m:eu:rent|m:9:R	1
taire	t:ai:re|t:E:R	1
ouïr	ou:ï:r|w:i:R	1
skiable	ski:a:ble|skj:a:bl	1
slaves	sl:a:ves|sl:a:v	1
chah	ch:ah:|S:a:	1
yeuse	y:eu:se|j:2:z	1
urne	:u:rne|:y:Rn	1
muet	mu:et:|m8:E:	1
jases	j:a:ses|Z:a:z	1
lek	l:e:k|l:E:k	1
cogne	c:o:gne|k:O:N	1
quiz	qu:i:z|k:i:z	1
planent	pl:a:nent|pl:a:n	1
crasse	cr:a:sse|kR:a:s	1
fous	f:ous:|f:u:	1
jouis	jou:is:|Zw:i:	1
forgent	f:o:rgent|f:O:RZ	1
maquent	m:a:quent|m:a:k	1
mâle	m:â:le|m:a:l	1
suif	su:i:f|s8:i:f	1
blague	bl:a:gue|bl:a:g	1
coings	coi:ngs:|kw:5:	1
soirs	soi:r:s|sw:a:R	1
spot	sp:o:t|sp:O:t	1
ifs	:i:fs|:i:f	1
inde	:in:de|:5:d	1
lof	l:o:f|l:O:f	1
fuse	f:u:se|f:y:z	1
socles	s:o:cles|s:O:kl	1
mante	m:an:te|m:@:t	1
dînes	d:î:nes|d:i:n	1
bleue	bl:eue:|bl:2:	1
vaguent	v:a:guent|v:a:g	1
ça	ç:a:|s:a:	1
coulpe	c:ou:lpe|k:u:lp	1
sels	s:e:ls|s:E:l	1
baile	b:ai:le|b:e:l	1
tendre	t:en:dre|t:@:dR	1
cane	c:a:ne|k:a:n	1
saurs	s:au:rs|s:o:R	1
fuites	fu:i:tes|f8:i:t	1
douze	d:ou:ze|d:u:z	1
datte	d:at:te|d:a:t	1
mouais	mou:ais:|mw:E:	1
hongre	:ho:ngre|:§:gR	1
fête	f:ê:te|f:E:t	1
marche	m:a:rche|m:a:RS	1
textes	t:e:xtes|t:E:kst	1
serrent	s:er:rent|s:E:R	1
torse	t:o:rse|t:O:Rs	1
toques	t:o:ques|t:O:k	1
boîtes	bo:î:tes|bw:a:t	1
ars	:ar:s|:a:R	1
maint	ma:int:|m:5:	1
gousses	g:ou:sses|g:u:s	1
pontes	p:on:tes|p:§:t	1
hanche	:han:che|:@:S	1
nimbent	n:i:mbent|n:5:b	1
parte	p:a:rte|p:a:Rt	1
meubles	m:eu:bles|m:9:bl	1
trappe	tr:a:ppe|tR:a:p	1
chant	ch:ant:|S:@:	1
sniff	sn:i:ff|sn:i:f	1
hèle	:hè:le|:E:l	1
graisses	gr:ai:sses|gR:E:s	1
gueuses	g:ueu:ses|g:2:z	1
meufs	m:eu:fs|m:9:f	1
coffres	c:o:ffres|k:O:fR	1
tronc	tr:onc:|tR:§:	1
pores	p:o:res|p:O:R	1
roque	r:o:que|R:O:k	1
bout	bou:t:|b:u:	1
borgnes	b:o:rgnes|b:O:RN	1
broche	br:o:che|bR:O:S	1
copte	c:o:pte|k:O:pt	1
houx	:houx:|:u:	1
loque	l:o:que|l:O:k	1
frousse	fr:ou:sse|fR:u:s	1
croies	croi:es:|kRw:a:	1
râpe	r:â:pe|R:a:p	1
pèze	p:è:ze|p:E:z	1
ouais	ou:ais:|w:E:	1
bandent	b:an:dent|b:@:d	1
geais	ge:ais:|Z:E:	1
grasse	gr:a:sse|gR:a:s	1
rap	r:a:p|R:a:p	1
fiasque	fi:a:sque|fj:a:sk	1
thugs	t:hu:gs|t:y:g	1
fic	f:i:c|f:i:k	1
lyse	l:y:se|l:i:z	1
miaulent	mi:au:lent|mj:o:l	1
cambrent	c:a:mbrent|k:@:bR	1
lié	li:é:|lj:e:	1
aube	:au:be|:o:b	1
chu	ch:u:|S:y:	1
na	n:a:|n:a:	1
mômes	m:ô:mes|m:o:m	1
grils	gr:i:ls|gR:i:l	1
jambe	j:am:be|Z:@:b	1
charme	ch:a:rme|S:a:Rm	1
né	n:é:|n:e:	1
hunes	:hu:nes|:y:n	1
flanc	fla:nc:|fl:@:	1
loges	l:o:ges|l:O:Z	1
crashe	cr:as:he|kR:a:S	1
fautes	f:au:tes|f:o:t	1
dent	d:ent:|d:@:	1
schnoques	schn:o:ques|Sn:O:k	1
qui	qu:i:|k:i:	1
lames	l:a:mes|l:a:m	1
hargnes	:ha:rgnes|:a:RN	1
pomme	p:om:me|p:O:m	1
tweeds	twe:e:ds|tw:i:d	1
gisent	g:i:sent|Z:i:z	1
thermes	th:e:rmes|t:E:Rm	1
cistes	c:i:stes|s:i:st	1
witz	w:i:tz|w:i:tz	1
bouches	b:ou:ches|b:u:S	1
chieurs	chi:eur:s|Sj:9:R	1
tiens	tie:ns:|tj:5:	1
trousse	tr:ou:sse|tR:u:s	1
saints	s:aints:|s:5:	1
rouée	rou:ée:|Rw:e:	1
pât	p:ât:|p:a:	1
panses	p:an:ses|p:@:s	1
gogs	g:o:gs|g:O:g	1
bras	br:as:|bR:a:	1
coites	co:i:tes|kw:a:t	1
beauf	b:e:auf|b:o:f	1
stage	st:a:ge|st:a:Z	1
grain	gr:ain:|gR:5:	1
team	t:e:am|t:i:m	1
blond	bl:ond:|bl:§:	1
heurts	:heurt:s|:9:R	1
nue	n:ue:|n:y:	1
trams	tr:a:ms|tR:a:m	1
fuel	fu:e:l|fj:u:l	1
tee	t:ee:|t:i:	1
chope	ch:o:pe|S:O:p	1
bi	b:i:|b:i:	1
gousse	g:ou:sse|g:u:s	1
troc	tr:o:c|tR:O:k	1
sème	s:è:me|s:E:m	1
filtrent	f:i:ltrent|f:i:ltR	1
hugh	:hu:gh|:y:g	1
landes	l:an:des|l:@:d	1
mule	m:u:le|m:y:l	1
hochent	:ho:chent|:O:S	1
glaires	gl:ai:res|gl:E:R	1
suant	su:ant:|s8:@:	1
hêtres	:hê:tres|:E:tR	1
sûr	s:û:r|s:y:R	1
manche	m:an:che|m:@:S	1
blèches	bl:è:ches|bl:E:S	1
farde	f:a:rde|f:a:Rd	1
chiffres	ch:i:ffres|S:i:fR	1
vice	v:i:ce|v:i:s	1
bande	b:an:de|b:@:d	1
sexe	s:e:xe|s:E:ks	1
mît	m:ît:|m:i:	1
douches	d:ou:ches|d:u:S	1
poisses	po:i:sses|pw:a:s	1
foehn	f:oeh:n|f:2:n	1
ordres	:o:rdres|:O:RdR	1
pitch	p:i:tch|p:i:tS	1
plaques	pl:a:ques|pl:a:k	1
poulpes	p:ou:lpes|p:u:lp	1
bonnes	bo:n:nes|b:O:n	1
bornent	b:o:rnent|b:O:Rn	1
mue	m:ue:|m:y:	1
ciglent	c:i:glent|s:i:gl	1
hein	:hein:|:5:	1
saignes	s:ai:gnes|s:E:N	1
mates	m:a:tes|m:a:t	1
saille	s:a:ille|s:a:j	1
froisses	fro:i:sses|fRw:a:s	1
hip	:hi:p|:i:p	1
broches	br:o:ches|bR:O:S	1
jure	j:u:re|Z:y:R	1
vends	v:ends:|v:@:	1
ides	:i:des|:i:d	1
schiste	sch:i:ste|S:i:st	1
poupe	p:ou:pe|p:u:p	1
watt	w:a:tt|w:a:t	1
gires	g:i:res|Z:i:R	1
beurk	b:eu:rk|b:9:Rk	1
vrai	vr:ai:|vR:E:	1
route	r:ou:te|R:u:t	1
sottes	s:ot:tes|s:O:t	1
bielles	bie:l:les|bj:E:l	1
kart	k:a:rt|k:a:Rt	1
presse	pr:e:sse|pR:E:s	1
hâve	:hâ:ve|:a:v	1
glandes	gl:an:des|gl:@:d	1
tueuse	tu:eu:se|t8:2:z	1
songent	s:on:gent|s:§:Z	1
faut	f:aut:|f:o:	1
fleur	fl:eu:r|fl:9:R	1
diète	di:è:te|dj:E:t	1
crown	cr:o:wn|kR:a:wn	1
meuvent	m:eu:vent|m:9:v	1
paument	p:au:ment|p:o:m	1
coure	c:ou:re|k:u:R	1
ont	:ont:|:§:	1
shorts	sh:o:rts|S:O:Rt	1
fiant	fi:ant:|fj:@:	1
pusses	p:u:sses|p:y:s	1
fleure	fl:eu:re|fl:9:R	1
sources	s:ou:rces|s:u:Rs	1
chiée	chi:ée:|Sj:e:	1
smart	sm:a:rt|sm:a:Rt	1
montre	m:on:tre|m:§:tR	1
toussent	t:ou:ssent|t:u:s	1
serait	ser:ait:|sR:E:	1
surfe	s:u:rfe|s:9:Rf	1
muon	mu:on:|m8:§:	1
tarse	t:a:rse|t:a:Rs	1
boxes	b:o:xes|b:O:ks	1
trames	tr:a:mes|tR:a:m	1
miss	m:i:ss|m:i:s	1
whist	wh:i:st|w:i:st	1
crics	cr:i:cs|kR:i:k	1
flubes	fl:u:bes|fl:y:b	1
coude	c:ou:de|k:u:d	1
gray	gr:ay:|gR:E:	1
pierre	pi:er:re|pj:E:R	1
pages	p:a:ges|p:a:Z	1
crèches	cr:è:ches|kR:E:S	1
chaumes	ch:au:mes|S:o:m	1
bigue	b:i:gue|b:i:g	1
peignes	p:e:ignes|p:E:N	1
opte	:o:pte|:O:pt	1
riff	r:i:ff|R:i:f	1
goum	g:ou:m|g:u:m	1
rythmes	r:yt:hmes|R:i:tm	1
coûte	co:û:te|k:u:t	1
pions	pi:ons:|pj:§:	1
hertz	:he:rtz|:E:Rts	1
prises	pr:i:ses|pR:i:z	1
joue	jou:e:|Z:u:	1
jaune	j:au:ne|Z:o:n	1
tilles	t:i:lles|t:i:j	1
kraft	kr:a:ft|kR:a:ft	1
noire	no:i:re|nw:a:R	1
max	m:a:x|m:a:ks	1
pourpres	p:ou:rpres|p:u:RpR	1
doives	do:i:ves|dw:a:v	1
tintent	t:in:tent|t:5:t	1
trips	tr:i:ps|tR:i:p	1
seize	s:e:ize|s:E:z	1
manques	m:an:ques|m:@:k	1
glane	gl:a:ne|gl:a:n	1
freinent	fr:e:inent|fR:E:n	1
japs	j:a:ps|Z:a:p	1
bar	b:a:r|b:a:R	1
lueur	lu:eu:r|l8:9:R	1
flic	fl:i:c|fl:i:k	1
gouache	gou:a:che|gw:a:S	1
phases	ph:a:ses|f:a:z	1
laque	l:a:que|l:a:k	1
dunes	d:u:nes|d:y:n	1
ruine	ru:i:ne|R8:i:n	1
piquent	p:i:quent|p:i:k	1
pleine	pl:e:ine|pl:E:n	1
gord	g:o:rd|g:O:R	1
fées	f:ées:|f:e:	1
lattes	la:t:tes|l:a:t	1
geste	g:e:ste|Z:E:st	1
chiés	chi:és:|Sj:e:	1
skiais	ski:ais:|skj:E:	1
digne	d:i:gne|d:i:N	1
plate	pl:a:te|pl:a:t	1
pesse	p:e:sse|p:E:s	1
hante	:han:te|:@:t	1
comte	co:m:te|k:§:t	1
su	s:u:|s:y:	1
rie	r:ie:|R:i:	1
paissent	p:ai:ssent|p:E:s	1
fais	f:ais:|f:E:	1
feutrent	f:eu:trent|f:2:tR	1
sar	s:a:r|s:a:R	1
bières	bi:è:res|bj:E:R	1
joules	j:ou:les|Z:u:l	1
maigres	m:ai:gres|m:E:gR	1
bonds	b:onds:|b:§:	1
tek	t:e:k|t:E:k	1
gosses	g:o:sses|g:O:s	1
de	d:e:|d:2:	1
sève	s:è:ve|s:E:v	1
snobs	sn:o:bs|sn:O:b	1
block	bl:o:ck|bl:O:k	1
soin	soi:n:|sw:5:	1
hourds	:hourd:s|:u:R	1
goûte	g:oû:te|g:u:t	1
geint	ge:int:|Z:5:	1
vroom	vr:o:om|vR:u:m	1
bols	b:o:ls|b:O:l	1
orque	:o:rque|:O:Rk	1
oh	:oh:|:o:	1
juste	j:u:ste|Z:y:st	1
bottent	b:ot:tent|b:O:t	1
rendes	r:en:des|R:@:d	1
kyste	k:y:ste|k:i:st	1
glacent	gla:c:ent|gl:a:s	1
bourge	b:ou:rge|b:u:RZ	1
souples	s:ou:ples|s:u:pl	1
rings	r:i:ngs|R:i:G	1
pulpes	p:u:lpes|p:y:lp	1
snob	sn:o:b|sn:O:b	1
griffe	gr:i:ffe|gR:i:f	1
bug	b:u:g|b:9:g	1
ouïs	ouï:s:|w:i:	1
chèques	ch:è:ques|S:E:k	1
quintes	qu:in:tes|k:5:t	1
craignes	cr:ai:gnes|kR:E:N	1
rire	r:i:re|R:i:R	1
môle	m:ô:le|m:o:l	1
fougues	f:ou:gues|f:u:g	1
cabs	c:a:bs|k:a:b	1
traie	tr:aie:|tR:E:	1
âtre	:â:tre|:a:tR	1
quittes	qu:it:tes|k:i:t	1
toiles	to:i:les|tw:a:l	1
muges	m:u:ges|m:y:Z	1
date	d:a:te|d:a:t	1
mois	moi:s:|mw:a:	1
prie	pr:ie:|pR:i:	1
cerne	c:e:rne|s:E:Rn	1
sud	s:u:d|s:y:d	1
jèze	j:è:ze|Z:E:z	1
bisques	b:i:sques|b:i:sk	1
fêles	f:ê:les|f:E:l	1
pointes	po:in:tes|pw:5:t	1
libre	l:i:bre|l:i:bR	1
nièce	ni:è:ce|nj:E:s	1
tint	t:int:|t:5:	1
baisse	b:ai:sse|b:E:s	1
pers	p:e:rs|p:E:R	1
caisses	c:ai:sses|k:E:s	1
maie	m:aie:|m:E:	1
août	:aoû:t|:u:t	1
fût	f:ût:|f:y:	1
pad	p:a:d|p:a:d	1
pro	pr:o:|pR:o:	1
ais	:ais:|:e:	1
crins	cr:ins:|kR:5:	1
mèche	m:è:che|m:E:S	1
hantes	:han:tes|:@:t	1
mauves	m:au:ves|m:o:v	1
burg	b:u:rg|b:9:Rg	1
ouvrent	:ou:vrent|:u:vR	1
mettent	m:et:tent|m:E:t	1
eh	:eh:|:e:	1
czars	cz:a:rs|kz:a:R	1
dindes	d:in:des|d:5:d	1
surf	s:u:rf|s:9:Rf	1
prisse	pr:i:sse|pR:i:s	1
riffs	r:i:ffs|R:i:f	1
duo	du:o:|d8:o:	1
mêle	m:ê:le|m:E:l	1
spermes	sp:e:rmes|sp:E:Rm	1
coi	co:i:|kw:a:	1
rait	r:ait:|R:E:	1
darne	d:a:rne|d:a:Rn	1
tièdes	ti:è:des|tj:E:d	1
train	tr:ain:|tR:5:	1
fourgues	f:ou:rgues|f:u:Rg	1
diane	di:a:ne|dj:a:n	1
prive	pr:i:ve|pR:i:v	1
boude	b:ou:de|b:u:d	1
sabrent	s:a:brent|s:a:bR	1
square	squ:a:re|skw:a:R	1
croisent	croi:s:ent|kRw:a:z	1
apte	:a:pte|:a:pt	1
grip	gr:i:p|gR:i:p	1
vaut	v:aut:|v:o:	1
stages	st:a:ges|st:a:Z	1
tome	t:o:me|t:O:m	1
muée	mu:ée:|m8:e:	1
vioc	vi:o:c|vj:O:k	1
rouissent	rou:i:ssent|Rw:i:s	1
frôles	fr:ô:les|fR:o:l	1
due	d:ue:|d:y:	1
gîtent	g:î:tent|Z:i:t	1
baffles	b:a:ffles|b:a:fl	1
kids	k:i:ds|k:i:d	1
prend	pr:end:|pR:@:	1
pieds	pie:ds:|pj:e:	1
bruire	bru:i:re|bR8:i:R	1
vlan	vl:an:|vl:@:	1
veine	v:e:ine|v:E:n	1
hurles	:hu:rles|:y:Rl	1
frocs	fr:o:cs|fR:O:k	1
stupre	st:u:pre|st:y:pR	1
style	st:y:le|st:i:l	1
côte	c:ô:te|k:o:t	1
troncs	tr:oncs:|tR:§:	1
nu	n:u:|n:y:	1
speede	spe:e:de|sp:i:d	1
dut	d:ut:|d:y:	1
golf	g:o:lf|g:O:lf	1
touillent	t:ou:illent|t:u:j	1
drisse	dr:i:sse|dR:i:s	1
creek	cr:e:ek|kR:i:k	1
serres	s:er:res|s:E:R	1
marks	m:a:rks|m:a:Rk	1
tsar	ts:a:r|ts:a:R	1
reîtres	r:e:îtres|R:E:tR	1
beignes	b:e:ignes|b:E:N	1
as	:as:|:a:	1
rends	r:ends:|R:@:	1
arde	:a:rde|:a:Rd	1
ruer	ru:er:|R8:e:	1
poche	p:o:che|p:O:S	1
flux	fl:ux:|fl:y:	1
taure	t:au:re|t:o:R	1
capes	c:a:pes|k:a:p	1
souhait	sou:hait:|sw:E:	1
croie	croi:e:|kRw:a:	1
huiles	hu:i:les|8:i:l	1
boums	b:ou:ms|b:u:m	1
fiés	fi:és:|fj:e:	1
bogue	b:o:gue|b:O:g	1
sacs	s:a:cs|s:a:k	1
glaise	gl:ai:se|gl:E:z	1
brave	br:a:ve|bR:a:v	1
squeeze	sque:e:ze|skw:i:z	1
là	l:à:|l:a:	1
grecques	gre:c:ques|gR:E:k	1
cafre	c:a:fre|k:a:fR	1
dament	d:a:ment|d:a:m	1
trousses	tr:ou:sses|tR:u:s	1
pond	p:ond:|p:§:	1
sèche	s:è:che|s:E:S	1
butte	b:ut:te|b:y:t	1
tiares	ti:a:res|tj:a:R	1
ail	:a:il|:a:j	1
somme	s:om:me|s:O:m	1
poses	p:o:ses|p:o:z	1
jactes	j:a:ctes|Z:a:kt	1
moose	mo:o:se|m:u:z	1
hou	:hou:|:u:	1
jouet	jou:et:|Zw:E:	1
portes	p:o:rtes|p:O:Rt	1
gîtes	g:î:tes|Z:i:t	1
hâle	:hâ:le|:a:l	1
hai	:hai:|:E:	1
serfs	s:e:rfs|s:E:R	1
brillent	br:i:llent|bR:i:j	1
nielle	nie:l:le|nj:E:l	1
garent	g:a:rent|g:a:R	1
ruait	ru:ait:|R8:E:	1
dope	d:o:pe|d:O:p	1
rieuses	rie:u:ses|Rj:2:z	1
prenne	pr:en:ne|pR:E:n	1
couard	cou:a:rd|kw:a:R	1
fourme	f:ou:rme|f:u:Rm	1
nommes	no:m:mes|n:O:m	1
prêtre	pr:ê:tre|pR:E:tR	1
psaume	ps:au:me|ps:o:m	1
ronces	r:on:ces|R:§:s	1
gifle	g:i:fle|Z:i:fl	1
brins	br:ins:|bR:5:	1
drag	dr:a:g|dR:a:g	1
aise	:a:ise|:E:z	1
have	:ha:ve|:a:v	1
fie	f:ie:|f:i:	1
fruits	frui:ts:|fR8:i:	1
germe	g:e:rme|Z:E:Rm	1
tranchent	tr:an:chent|tR:@:S	1
thrène	thr:è:ne|tR:E:n	1
dirent	d:i:rent|d:i:R	1
dures	d:u:res|d:y:R	1
full	f:u:ll|f:u:l	1
lev	l:e:v|l:E:v	1
chier	chie:r:|Sj:e:	1
feuille	f:eu:ille|f:9:j	1
hué	h:ué:|8:e:	1
choir	cho:i:r|Sw:a:R	1
liste	l:i:ste|l:i:st	1
coing	coi:ng:|kw:5:	1
pende	p:en:de|p:@:d	1
mètres	m:è:tres|m:E:tR	1
frustre	fr:u:stre|fR:y:stR	1
piège	pi:è:ge|pj:E:Z	1
lux	l:u:x|l:y:ks	1
vies	v:ies:|v:i:	1
rayent	ra:y:ent|R:e:j	1
morte	m:o:rte|m:O:Rt	1
batte	b:at:te|b:a:t	1
souffre	s:ou:ffre|s:u:fR	1
rho	r:ho:|R:o:	1
diacres	di:a:cres|dj:a:kR	1
looks	lo:o:ks|l:u:ks	1
primes	pr:i:mes|pR:i:m	1
sceptres	sc:e:ptres|s:E:ptR	1
digue	d:i:gue|d:i:g	1
pute	p:u:te|p:y:t	1
blanche	bl:an:che|bl:@:S	1
meutes	m:eu:tes|m:2:t	1
dardent	d:a:rdent|d:a:Rd	1
rixe	r:i:xe|R:i:ks	1
sucs	s:u:cs|s:y:k	1
lourde	l:ou:rde|l:u:Rd	1
tare	t:a:re|t:a:R	1
blagues	bl:a:gues|bl:a:g	1
seuils	s:eu:ils|s:9:j	1
yèbles	y:è:bles|j:E:bl	1
gobent	g:o:bent|g:O:b	1
gouine	gou:i:ne|gw:i:n	1
taupe	t:au:pe|t:o:p	1
parc	p:a:rc|p:a:Rk	1
nettes	ne:t:tes|n:E:t	1
yue	y:ue:|j:y:	1
grays	gr:ays:|gR:E:	1
choux	ch:oux:|S:u:	1
bauges	b:au:ges|b:o:Z	1
tchèque	tch:è:que|tS:E:k	1
riz	r:iz:|R:i:	1
rance	r:an:ce|R:@:s	1
gold	g:o:ld|g:O:ld	1
sigle	s:i:gle|s:i:gl	1
elfes	:e:lfes|:E:lf	1
cendres	c:en:dres|s:@:dR	1
ni	n:i:|n:i:	1
joueur	jou:eu:r|Zw:9:R	1
vident	v:i:dent|v:i:d	1
panse	p:an:se|p:@:s	1
brut	br:u:t|bR:y:t	1
trisse	tr:i:sse|tR:i:s	1
ancre	:an:cre|:@:kR	1
poires	po:i:res|pw:a:R	1
shingle	sh:in:gle|S:5:gl	1
trax	tr:a:x|tR:a:ks	1
loin	loi:n:|lw:5:	1
rôts	r:ôts:|R:o:	1
troll	tr:o:ll|tR:O:l	1
hasch	:has:ch|:a:S	1
flops	fl:o:ps|fl:O:p	1
tourde	t:ou:rde|t:u:Rd	1
paît	p:aît:|p:E:	1
verbes	v:e:rbes|v:E:Rb	1
courre	c:our:re|k:u:R	1
vastes	v:a:stes|v:a:st	1
chaste	ch:a:ste|S:a:st	1
kils	k:i:ls|k:i:l	1
vannes	v:a:nnes|v:a:n	1
light	li:g:ht|l:a:jt	1
basques	b:a:sques|b:a:sk	1
baves	b:a:ves|b:a:v	1
pestent	p:e:stent|p:E:st	1
hom	:ho:m|:O:m	1
traître	tr:aî:tre|tR:E:tR	1
quetsche	qu:e:tsche|kw:E:tS	1
ney	n:ey:|n:e:	1
fisse	f:i:sse|f:i:s	1
puait	pu:ait:|p8:E:	1
buffles	b:u:ffles|b:y:fl	1
chiants	chia:nts:|Sj:@:	1
lâche	l:â:che|l:a:S	1
craques	cr:a:ques|kR:a:k	1
savent	s:a:vent|s:a:v	1
lisse	l:i:sse|l:i:s	1
pack	p:a:ck|p:a:k	1
branlent	br:an:lent|bR:@:l	1
soeur	so:eu:r|s:9:R	1
marnent	m:a:rnent|m:a:Rn	1
bips	b:i:ps|b:i:p	1
sert	s:e:rt|s:E:R	1
zèbres	z:è:bres|z:E:bR	1
mièvres	mi:è:vres|mj:E:vR	1
balle	b:al:le|b:a:l	1
chefs	ch:e:fs|S:E:f	1
perse	p:e:rse|p:E:Rs	1
poids	poi:ds:|pw:a:	1
lances	l:an:ces|l:@:s	1
sentent	s:en:tent|s:@:t	1
gênes	g:ê:nes|Z:E:n	1
brève	br:è:ve|bR:E:v	1
cessent	c:e:ssent|s:E:s	1
boites	bo:i:tes|bw:a:t	1
plan	pl:an:|pl:@:	1
serges	s:e:rges|s:E:RZ	1
laits	l:aits:|l:E:	1
ore	:o:re|:O:R	1
clamp	cla:m:p|kl:@:p	1
faits	f:aits:|f:E:	1
risque	r:i:sque|R:i:sk	1
pont	p:ont:|p:§:	1
oeils	:oe:ils|:9:j	1
tex	t:e:x|t:E:ks	1
foulent	f:ou:lent|f:u:l	1
mime	m:i:me|m:i:m	1
frète	fr:è:te|fR:E:t	1
rime	r:i:me|R:i:m	1
boueuse	bou:eu:se|bw:2:z	1
bouée	bou:ée:|bw:e:	1
bêchent	b:ê:chent|b:E:S	1
pinte	p:in:te|p:5:t	1
praire	pr:ai:re|pR:E:R	1
fouine	fou:i:ne|fw:i:n	1
sauvent	s:au:vent|s:o:v	1
fosse	f:o:sse|f:O:s	1
clampe	cla:m:pe|kl:@:p	1
chaînes	ch:aî:nes|S:E:n	1
nains	na:ins:|n:5:	1
trave	tr:a:ve|tR:a:v	1
cèpe	c:è:pe|s:E:p	1
messes	m:e:sses|m:E:s	1
voit	voi:t:|vw:a:	1
skaal	ska:a:l|sk:a:l	1
foncent	f:onc:ent|f:§:s	1
skieurs	ski:eur:s|skj:9:R	1
fouir	fou:i:r|fw:i:R	1
dartres	d:a:rtres|d:a:RtR	1
ires	:i:res|:i:R	1
phones	ph:o:nes|f:o:n	1
telle	t:el:le|t:E:l	1
contre	c:on:tre|k:§:tR	1
fichent	f:i:chent|f:i:S	1
mainte	ma:in:te|m:5:t	1
vrais	vr:ais:|vR:E:	1
fleurent	fl:eu:rent|fl:9:R	1
malle	ma:l:le|m:a:l	1
piste	p:i:ste|p:i:st	1
splash	spl:a:sh|spl:a:S	1
postent	p:o:stent|p:O:st	1
permes	p:e:rmes|p:E:Rm	1
pfutt	pf:ut:t|pf:y:t	1
yen	y:e:n|j:E:n	1
plèvres	pl:è:vres|pl:E:vR	1
phot	ph:o:t|f:O:t	1
lires	l:i:res|l:i:R	1
croises	croi:s:es|kRw:a:z	1
sots	s:ots:|s:o:	1
doigt	doi:gt:|dw:a:	1
tab	t:a:b|t:a:b	1
coincent	coi:nc:ent|kw:5:s	1
crut	cr:ut:|kR:y:	1
muids	mui:ds:|m8:i:	1
madre	m:a:dre|m:a:dR	1
tans	t:ans:|t:@:	1
sué	su:é:|s8:e:	1
datent	d:a:tent|d:a:t	1
fuguent	f:u:guent|f:y:g	1
musc	m:u:sc|m:y:sk	1
vits	v:its:|v:i:	1
goure	g:ou:re|g:u:R	1
bluffent	bl:u:ffent|bl:9:f	1
script	scr:i:pt|skR:i:pt	1
ceins	ce:ins:|s:5:	1
glisses	gl:i:sses|gl:i:s	1
palmes	p:a:lmes|p:a:lm	1
clés	cl:és:|kl:e:	1
ceps	c:e:ps|s:E:p	1
mirent	m:i:rent|m:i:R	1
rouge	r:ou:ge|R:u:Z	1
flemme	fl:e:mme|fl:E:m	1
toutes	t:ou:tes|t:u:t	1
cirent	c:i:rent|s:i:R	1
jurent	j:u:rent|Z:y:R	1
cage	c:a:ge|k:a:Z	1
vogues	v:o:gues|v:O:g	1
suie	sui:e:|s8:i:	1
triches	tr:i:ches|tR:i:S	1
couves	c:ou:ves|k:u:v	1
haque	:ha:que|:a:k	1
chiure	chi:u:re|Sj:y:R	1
jouant	jou:ant:|Zw:@:	1
farces	f:a:rces|f:a:Rs	1
barje	b:a:rje|b:a:RZ	1
frac	fr:a:c|fR:a:k	1
mens	m:ens:|m:@:	1
blanches	bl:an:ches|bl:@:S	1
teinte	te:in:te|t:5:t	1
able	:a:ble|:a:bl	1
nôtres	n:ô:tres|n:o:tR	1
sucres	s:u:cres|s:y:kR	1
houppes	:houp:pes|:u:p	1
loueuse	lou:eu:se|lw:2:z	1
bête	b:ê:te|b:E:t	1
siègent	si:è:gent|sj:E:Z	1
tourbes	t:ou:rbes|t:u:Rb	1
tinssent	t:in:ssent|t:5:s	1
murent	m:u:rent|m:y:R	1
joignes	jo:i:gnes|Zw:a:N	1
seigle	s:e:igle|s:E:gl	1
fringue	fr:in:gue|fR:5:g	1
mantes	m:an:tes|m:@:t	1
es	:es:|:E:	1
couchent	c:ou:chent|k:u:S	1
plaît	pla:ît:|pl:E:	1
chouan	chou:an:|Sw:@:	1
frimes	fr:i:mes|fR:i:m	1
houp	:hou:p|:u:p	1
chand	ch:and:|S:@:	1
pains	p:ains:|p:5:	1
gouaches	gou:a:ches|gw:a:S	1
gains	ga:ins:|g:5:	1
soul	s:ou:l|s:u:l	1
pou	p:ou:|p:u:	1
ongle	:on:gle|:§:gl	1
sept	s:e:pt|s:E:t	1
bûche	b:û:che|b:y:S	1
tires	t:i:res|t:i:R	1
vêt	v:êt:|v:E:	1
lys	l:y:s|l:i:s	1
trip	tr:i:p|tR:i:p	1
raques	r:a:ques|R:a:k	1
plombs	pl:ombs:|pl:§:	1
rhombe	r:hom:be|R:§:b	1
salve	s:a:lve|s:a:lv	1
sphaigne	sph:ai:gne|sf:E:N	1
froide	fro:i:de|fRw:a:d	1
roide	ro:i:de|Rw:a:d	1
crûmes	cr:û:mes|kR:y:m	1
stokes	st:o:kes|st:O:ks	1
piaules	pi:au:les|pj:o:l	1
baume	b:au:me|b:o:m	1
nuques	n:u:ques|n:y:k	1
gares	g:a:res|g:a:R	1
tille	t:i:lle|t:i:j	1
oint	o:int:|w:5:	1
rades	r:a:des|R:a:d	1
guildes	gu:i:ldes|g:i:ld	1
gainent	g:ai:nent|g:E:n	1
ôtent	:ô:tent|:o:t	1
piafs	pi:a:fs|pj:a:f	1
cannes	c:a:nnes|k:a:n	1
loques	l:o:ques|l:O:k	1
dussent	d:u:ssent|d:y:s	1
peut	p:eut:|p:2:	1
housses	:hou:sses|:u:s	1
ôtes	:ô:tes|:o:t	1
lierre	li:er:re|lj:E:R	1
bute	b:u:te|b:y:t	1
bacs	b:a:cs|b:a:k	1
squatte	squa:t:te|skw:a:t	1
choppe	ch:o:ppe|S:O:p	1
tins	t:ins:|t:5:	1
voies	voi:es:|vw:a:	1
muette	mu:et:te|m8:E:t	1
vendes	v:en:des|v:@:d	1
flambes	fla:m:bes|fl:@:b	1
dresses	dr:e:sses|dR:E:s	1
bielle	bie:l:le|bj:E:l	1
brook	br:o:ok|bR:u:k	1
graal	gr:a:al|gR:a:l	1
troche	tr:o:che|tR:O:S	1
mors	m:or:s|m:O:R	1
votre	v:o:tre|v:O:tR	1
cairns	c:ai:rns|k:E:Rn	1
moles	m:o:les|m:O:l	1
porche	p:o:rche|p:O:RS	1
rides	r:i:des|R:i:d	1
quelles	que:l:les|k:E:l	1
axes	:a:xes|:a:ks	1
forts	f:o:rts|f:O:R	1
plaident	pl:ai:dent|pl:E:d	1
claque	cl:a:que|kl:a:k	1
prisme	pr:i:sme|pR:i:zm	1
deuche	d:eu:che|d:2:S	1
fouettent	fou:et:tent|fw:E:t	1
valent	v:a:lent|v:a:l	1
pis	p:is:|p:i:	1
fièvre	fi:è:vre|fj:E:vR	1
chaque	ch:a:que|S:a:k	1
rose	r:o:se|R:o:z	1
steppe	st:e:ppe|st:E:p	1
causent	c:au:sent|k:o:z	1
bectent	b:e:ctent|b:E:kt	1
gages	g:a:ges|g:a:Z	1
gone	g:o:ne|g:o:n	1
drive	dr:i:ve|dR:a:jv	1
voué	vou:é:|vw:e:	1
crades	cr:a:des|kR:a:d	1
taillent	t:a:illent|t:a:j	1
cures	c:u:res|k:y:R	1
sketch	sk:e:tch|sk:E:tS	1
rouges	r:ou:ges|R:u:Z	1
briefe	br:i:efe|bR:i:f	1
fiches	f:i:ches|f:i:S	1
frêles	fr:ê:les|fR:E:l	1
brisent	br:i:sent|bR:i:z	1
volve	v:o:lve|v:O:lv	1
feue	f:eue:|f:2:	1
coche	c:o:che|k:O:S	1
jactent	j:a:ctent|Z:a:kt	1
meute	m:eu:te|m:2:t	1
doses	d:o:ses|d:o:z	1
busse	b:u:sse|b:y:s	1
staff	st:a:ff|st:a:f	1
tournent	t:ou:rnent|t:u:Rn	1
ruèrent	ru:è:rent|R8:E:R	1
unes	:u:nes|:y:n	1
da	d:a:|d:a:	1
teins	te:ins:|t:5:	1
rifles	r:i:fles|R:i:fl	1
narre	n:ar:re|n:a:R	1
pale	p:a:le|p:a:l	1
gore	g:o:re|g:O:R	1
foil	f:o:il|f:O:jl	1
eûtes	:eû:tes|:y:t	1
plages	pl:a:ges|pl:a:Z	1
clame	cl:a:me|kl:a:m	1
eut	:eut:|:y:	1
croule	cr:ou:le|kR:u:l	1
gouffres	g:ou:ffres|g:u:fR	1
clercs	cl:e:rcs|kl:E:R	1
autre	:au:tre|:o:tR	1
rennes	r:en:nes|R:E:n	1
pote	p:o:te|p:O:t	1
pros	pr:os:|pR:o:	1
fosses	f:o:sses|f:O:s	1
parme	p:a:rme|p:a:Rm	1
drink	dr:in:k|dR:5:k	1
pète	p:è:te|p:E:t	1
lands	l:an:ds|l:@:d	1
jungles	j:u:ngles|Z:1:gl	1
raites	r:ai:tes|R:E:t	1
base	b:a:se|b:a:z	1
grillent	gr:i:llent|gR:i:j	1
noués	nou:és:|nw:e:	1
troupe	tr:ou:pe|tR:u:p	1
rocks	r:o:cks|R:O:k	1
matche	m:a:tche|m:a:tS	1
rain	ra:in:|R:5:	1
lèpres	l:è:pres|l:E:pR	1
trônes	tr:ô:nes|tR:o:n	1
treuils	tr:eu:ils|tR:9:j	1
crabes	cr:a:bes|kR:a:b	1
myrrhe	m:yrrh:e|m:i:R	1
viables	vi:a:bles|vj:a:bl	1
schismes	sch:i:smes|S:i:zm	1
campes	c:am:pes|k:@:p	1
puisqu	pu:i:squ|p8:i:sk	1
sils	s:i:ls|s:i:l	1
sage	s:a:ge|s:a:Z	1
gangs	g:an:gs|g:@:g	1
clinche	cl:in:che|kl:5:S	1
strasse	str:a:sse|stR:a:s	1
dort	d:or:t|d:O:R	1
mythe	m:yth:e|m:i:t	1
nuise	nu:i:se|n8:i:z	1
nuis	nui:s:|n8:i:	1
lasses	l:a:sses|l:a:s	1
longent	l:on:gent|l:§:Z	1
flave	fl:a:ve|fl:a:v	1
prestes	pr:e:stes|pR:E:st	1
ait	:ait:|:e:	1
pusse	p:u:sse|p:y:s	1
maques	m:a:ques|m:a:k	1
burent	b:u:rent|b:y:R	1
ânes	:â:nes|:a:n	1
bordj	b:o:rdj|b:O:RdZ	1
tas	t:as:|t:a:	1
sires	s:i:res|s:i:R	1
tés	t:és:|t:e:	1
pâques	p:â:ques|p:a:k	1
crues	cr:ues:|kR:y:	1
ces	c:es:|s:e:	1
cille	c:i:lle|s:i:j	1
zain	za:in:|z:5:	1
lieur	li:eu:r|lj:9:R	1
drames	dr:a:mes|dR:a:m	1
mènent	m:è:nent|m:E:n	1
frein	fr:ein:|fR:5:	1
quête	qu:ê:te|k:E:t	1
rouvrent	r:ou:vrent|R:u:vR	1
case	c:a:se|k:a:z	1
gauss	g:au:ss|g:o:s	1
lasse	l:a:sse|l:a:s	1
sein	s:ein:|s:5:	1
coudes	c:ou:des|k:u:d	1
moues	m:oues:|m:u:	1
humbles	:hu:mbles|:1:bl	1
tinrent	t:in:rent|t:5:R	1
for	f:o:r|f:O:R	1
rêne	r:ê:ne|R:E:n	1
ventre	v:en:tre|v:@:tR	1
peux	p:eux:|p:2:	1
vulve	v:u:lve|v:y:lv	1
mente	m:en:te|m:@:t	1
grives	gr:i:ves|gR:i:v	1
carpe	c:a:rpe|k:a:Rp	1
carrent	c:ar:rent|k:a:R	1
liées	li:ées:|lj:e:	1
schnoque	schn:o:que|Sn:O:k	1
juin	ju:in:|Z8:5:	1
vole	v:o:le|v:O:l	1
juifs	ju:i:fs|Z8:i:f	1
dusses	d:u:sses|d:y:s	1
seules	s:eu:les|s:9:l	1
la	l:a:|l:a:	1
rouelle	rou:el:le|Rw:E:l	1
court	c:ou:rt|k:u:R	1
cuisse	cu:i:sse|k8:i:s	1
tussent	t:u:ssent|t:y:s	1
offre	:o:ffre|:O:fR	1
sculptent	sc:u:lptent|sk:y:lt	1
moos	mo:o:s|m:O:s	1
fanes	f:a:nes|f:a:n	1
veuilles	v:eu:illes|v:9:j	1
sloop	sl:o:op|sl:u:p	1
brie	br:ie:|bR:i:	1
gong	g:on:g|g:§:g	1
merles	m:e:rles|m:E:Rl	1
disent	d:i:sent|d:i:z	1
ondes	:on:des|:§:d	1
a	:a:|:a:	1
planchent	pl:an:chent|pl:@:S	1
boutre	b:ou:tre|b:u:tR	1
scié	sci:é:|sj:e:	1
notre	n:o:tre|n:O:tR	1
scièrent	sci:è:rent|sj:E:R	1
coiffes	coiff:e:s|kw:a:f	1
blattes	bla:t:tes|bl:a:t	1
procs	pr:o:cs|pR:O:k	1
moindres	mo:in:dres|mw:5:dR	1
tentes	t:en:tes|t:@:t	1
connes	co:n:nes|k:O:n	1
haines	:hai:nes|:E:n	1
hères	:hè:res|:E:R	1
poches	p:o:ches|p:O:S	1
diantre	di:an:tre|dj:@:tR	1
taise	t:ai:se|t:E:z	1
druzes	dr:u:zes|dR:y:z	1
tares	t:a:res|t:a:R	1
flans	fla:ns:|fl:@:	1
tu	t:u:|t:y:	1
siestes	si:e:stes|sj:E:st	1
fiche	f:i:che|f:i:S	1
terce	t:e:rce|t:E:Rs	1
prêtent	pr:ê:tent|pR:E:t	1
taille	t:a:ille|t:a:j	1
nimbe	n:im:be|n:5:b	1
grouilles	gr:ou:illes|gR:u:j	1
wouah	w:ouah:|w:a:	1
ronce	r:on:ce|R:§:s	1
vexes	v:e:xes|v:E:ks	1
clou	cl:ou:|kl:u:	1
ghât	g:hât:|g:a:	1
pluie	plui:e:|pl8:i:	1
tartre	t:a:rtre|t:a:RtR	1
naisse	n:ai:sse|n:E:s	1
battre	b:a:ttre|b:a:tR	1
rus	r:us:|R:y:	1
tord	t:o:rd|t:O:R	1
chaire	ch:ai:re|S:E:R	1
chantres	ch:an:tres|S:@:tR	1
sûre	s:û:re|s:y:R	1
labres	l:a:bres|l:a:bR	1
riant	ri:ant:|Rj:@:	1
foires	fo:i:res|fw:a:R	1
souhaits	sou:haits:|sw:E:	1
noeud	no:eud:|n:2:	1
butes	b:u:tes|b:y:t	1
tubes	t:u:bes|t:y:b	1
fasse	f:a:sse|f:a:s	1
ronges	r:on:ges|R:§:Z	1
sphinge	sph:in:ge|sf:5:Z	1
pinces	p:in:ces|p:5:s	1
cirses	c:i:rses|s:i:Rs	1
diem	di:e:m|dj:E:m	1
croissent	cro:i:ssent|kRw:a:s	1
cris	cr:is:|kR:i:	1
maille	m:a:ille|m:a:j	1
tong	t:on:g|t:§:g	1
scènes	s:cè:nes|s:E:n	1
piochent	pi:o:chent|pj:O:S	1
moeurs	mo:eu:rs|m:9:Rs	1
figues	f:i:gues|f:i:g	1
turent	t:u:rent|t:y:R	1
fêtes	f:ê:tes|f:E:t	1
dièses	di:è:ses|dj:E:z	1
chnouf	chn:ou:f|Sn:u:f	1
troublent	tr:ou:blent|tR:u:bl	1
jèzes	jèz:e:s|Z:E:z	1
louage	lou:a:ge|lw:a:Z	1
vaps	v:a:ps|v:a:p	1
zieute	zie:u:te|zj:2:t	1
oindre	o:in:dre|w:5:dR	1
cambre	c:a:mbre|k:@:bR	1
juge	j:u:ge|Z:y:Z	1
tac	t:a:c|t:a:k	1
hanches	:han:ches|:@:S	1
planque	pl:an:que|pl:@:k	1
stars	st:a:rs|st:a:R	1
lite	l:i:te|l:i:t	1
lancent	l:anc:ent|l:@:s	1
tique	t:i:que|t:i:k	1
feigne	f:e:igne|f:E:N	1
lèvres	l:è:vres|l:E:vR	1
mite	m:i:te|m:i:t	1
brisque	br:i:sque|bR:i:sk	1
shoot	sho:o:t|S:u:t	1
promptes	pr:omp:tes|pR:§:t	1
poule	p:ou:le|p:u:l	1
quant	qu:ant:|k:@:	1
tics	t:i:cs|t:i:k	1
più	pi:ù:|pj:u:	1
cuivres	cu:i:vres|k8:i:vR	1
taises	t:ai:ses|t:E:z	1
doive	do:i:ve|dw:a:v	1
cis	c:is:|s:i:	1
rouer	rou:er:|Rw:e:	1
martres	m:a:rtres|m:a:RtR	1
skinheads	skinh:e:ads|skj:E:d	1
tus	t:us:|t:y:	1
stades	st:a:des|st:a:d	1
craches	cr:a:ches|kR:a:S	1
douaire	dou:ai:re|dw:E:R	1
jouit	jou:it:|Zw:i:	1
bigle	b:i:gle|b:i:gl	1
gauche	g:au:che|g:o:S	1
mousse	m:ou:sse|m:u:s	1
musse	m:u:sse|m:y:s	1
goule	g:ou:le|g:u:l	1
krill	kr:i:ll|kR:i:l	1
cave	c:a:ve|k:a:v	1
closes	cl:o:ses|kl:o:z	1
acte	:a:cte|:a:kt	1
branche	br:an:che|bR:@:S	1
tact	t:a:ct|t:a:kt	1
pures	p:u:res|p:y:R	1
oeuvrent	:oe:uvrent|:9:vR	1
lymphes	l:ymphe:s|l:5:f	1
guède	g:uè:de|g:E:d	1
loufes	l:ou:fes|l:u:f	1
lès	l:ès:|l:E:	1
bigre	b:i:gre|b:i:gR	1
skis	ski:s:|sk:i:	1
cames	c:a:mes|k:a:m	1
vrille	vr:i:lle|vR:i:j	1
kid	k:i:d|k:i:d	1
eusse	:eu:sse|:y:s	1
ketch	k:e:tch|k:E:tS	1
nuance	nu:an:ce|n8:@:s	1
bigles	b:i:gles|b:i:gl	1
gerbes	g:e:rbes|Z:E:Rb	1
heurte	:heu:rte|:9:Rt	1
flats	fla:ts:|fl:a:	1
rhô	r:hô:|R:o:	1
tassent	t:a:ssent|t:a:s	1
heaume	:heau:me|:o:m	1
brassent	br:a:ssent|bR:a:s	1
feutre	f:eu:tre|f:2:tR	1
spitz	sp:i:tz|sp:i:ts	1
flint	fl:i:nt|fl:i:nt	1
coût	co:ût:|k:u:	1
diams	di:a:ms|dj:a:m	1
biles	b:i:les|b:i:l	1
ming	m:i:ng|m:i:G	1
veufs	v:eu:fs|v:9:f	1
trempes	tr:em:pes|tR:@:p	1
guigne	gu:i:gne|g:i:N	1
bire	b:i:re|b:i:R	1
fraye	fr:ay:e|fR:e:j	1
sikhs	s:i:khs|s:i:k	1
chauds	ch:auds:|S:o:	1
ornent	:o:rnent|:O:Rn	1
flots	fl:ots:|fl:o:	1
stresse	str:e:sse|stR:E:s	1
siens	sie:ns:|sj:5:	1
listes	l:i:stes|l:i:st	1
haves	:ha:ves|:a:v	1
must	m:u:st|m:9:st	1
halent	:ha:lent|:a:l	1
broies	broi:es:|bRw:a:	1
crue	cr:ue:|kR:y:	1
biches	b:i:ches|b:i:S	1
berces	b:e:rces|b:E:Rs	1
selles	s:el:les|s:E:l	1
plonge	pl:on:ge|pl:§:Z	1
collent	co:l:lent|k:O:l	1
sèchent	s:è:chent|s:E:S	1
sièges	si:è:ges|sj:E:Z	1
fin	f:in:|f:5:	1
narguent	n:a:rguent|n:a:Rg	1
criblent	cr:i:blent|kR:i:bl	1
fax	f:a:x|f:a:ks	1
brize	br:i:ze|bR:i:z	1
chanvres	ch:an:vres|S:@:vR	1
ouste	:ou:ste|:u:st	1
grappes	gr:a:ppes|gR:a:p	1
dît	d:ît:|d:i:	1
myrte	m:y:rte|m:i:Rt	1
grunge	gr:u:nge|gR:9:nZ	1
ganse	g:an:se|g:@:s	1
orges	:o:rges|:O:RZ	1
self	s:e:lf|s:E:lf	1
manquent	m:an:quent|m:@:k	1
crottes	cr:ot:tes|kR:O:t	1
rentes	r:en:tes|R:@:t	1
piaule	pi:au:le|pj:o:l	1
pansent	p:an:sent|p:@:s	1
sèves	s:è:ves|s:E:v	1
seuls	s:eu:ls|s:9:l	1
ver	v:e:r|v:E:R	1
touer	tou:er:|tw:e:	1
pec	p:e:c|p:E:k	1
flippent	fl:ip:pent|fl:i:p	1
ôte	:ô:te|:o:t	1
bridge	br:i:dge|bR:i:dZ	1
ne	n:e:|n:2:	1
rafle	r:a:fle|R:a:fl	1
cure	c:u:re|k:y:R	1
brides	br:i:des|bR:i:d	1
quêtes	qu:ê:tes|k:E:t	1
pauses	p:au:ses|p:o:z	1
roof	ro:o:f|R:u:f	1
huard	hu:a:rd|8:a:R	1
via	vi:a:|vj:a:	1
blessent	bl:e:ssent|bl:E:s	1
bisquent	b:i:squent|b:i:sk	1
bourse	b:ou:rse|b:u:Rs	1
il	:i:l|:i:l	1
kohl	k:oh:l|k:o:l	1
poissent	po:i:ssent|pw:a:s	1
niet	ni:e:t|nj:E:t	1
piaf	pi:a:f|pj:a:f	1
sale	s:a:le|s:a:l	1
talent	t:a:lent|t:a:l	1
clenches	cl:en:ches|kl:@:S	1
haltes	:ha:ltes|:a:lt	1
broutent	br:ou:tent|bR:u:t	1
rang	ra:ng:|R:@:	1
roides	ro:i:des|Rw:a:d	1
baud	b:aud:|b:o:	1
homme	:hom:me|:O:m	1
valsent	v:a:lsent|v:a:ls	1
horde	:ho:rde|:O:Rd	1
pièges	pi:è:ges|pj:E:Z	1
loft	l:o:ft|l:O:ft	1
suies	sui:es:|s8:i:	1
boise	boi:s:e|bw:a:z	1
chose	ch:o:se|S:o:z	1
chastes	ch:a:stes|S:a:st	1
gramme	gr:a:mme|gR:a:m	1
singent	s:in:gent|s:5:Z	1
congres	c:on:gres|k:§:gR	1
coures	c:ou:res|k:u:R	1
giflent	g:i:flent|Z:i:fl	1
meuh	m:euh:|m:2:	1
khans	kh:a:ns|k:a:n	1
pulse	p:u:lse|p:y:ls	1
zèbre	z:è:bre|z:E:bR	1
docte	d:o:cte|d:O:kt	1
classent	cl:a:ssent|kl:a:s	1
fils	f:i:ls|f:i:l	1
peuh	p:euh:|p:2:	1
outres	:ou:tres|:u:tR	1
pointe	po:in:te|pw:5:t	1
ski	sk:i:|sk:i:	1
choque	ch:o:que|S:O:k	1
jette	j:et:te|Z:E:t	1
smacks	sm:a:cks|sm:a:k	1
punch	p:un:ch|p:§:S	1
male	m:a:le|m:a:l	1
gèrent	g:è:rent|Z:E:R	1
floue	fl:oue:|fl:u:	1
cars	c:a:rs|k:a:R	1
tartes	t:a:rtes|t:a:Rt	1
blacks	bl:a:cks|bl:a:k	1
truite	tru:i:te|tR8:i:t	1
round	r:ou:nd|R:u:nd	1
ordre	:o:rdre|:O:RdR	1
lèches	l:è:ches|l:E:S	1
craint	cr:aint:|kR:5:	1
trônent	tr:ô:nent|tR:o:n	1
aigre	:ai:gre|:E:gR	1
courbes	c:ou:rbes|k:u:Rb	1
seul	s:eu:l|s:9:l	1
surs	s:ur:s|s:y:R	1
paille	p:a:ille|p:a:j	1
chou	ch:ou:|S:u:	1
chnord	chn:o:rd|kn:O:R	1
jets	je:t:s|dZ:E:t	1
terrent	t:er:rent|t:E:R	1
pennes	p:en:nes|p:E:n	1
bradent	br:a:dent|bR:a:d	1
raclent	r:a:clent|R:a:kl	1
jouisse	jou:i:sse|Zw:i:s	1
berme	b:e:rme|b:E:Rm	1
trains	tr:ains:|tR:5:	1
mitre	m:i:tre|m:i:tR	1
thaïs	th:a:ïs|t:a:j	1
chaude	ch:au:de|S:o:d	1
jouasse	jou:a:sse|Zw:a:s	1
hongres	:ho:ngres|:§:gR	1
stalles	st:al:les|st:a:l	1
combe	co:m:be|k:§:b	1
rams	r:a:ms|R:a:m	1
plût	pl:ût:|pl:y:	1
sied	sie:d:|sj:e:	1
clament	cl:a:ment|kl:a:m	1
lâchent	l:â:chent|l:a:S	1
logent	l:o:gent|l:O:Z	1
traits	tr:aits:|tR:E:	1
nets	n:e:ts|n:E:t	1
prêt	pr:êt:|pR:E:	1
blots	bl:ots:|bl:o:	1
flore	fl:o:re|fl:O:R	1
fuisse	fu:i:sse|f8:i:s	1
brûle	br:û:le|bR:y:l	1
joice	joi:c:e|Zw:a:s	1
crèche	cr:è:che|kR:E:S	1
offres	:o:ffres|:O:fR	1
bavent	b:a:vent|b:a:v	1
tulle	t:ul:le|t:y:l	1
coques	c:o:ques|k:O:k	1
ya	y:a:|j:a:	1
serbe	s:e:rbe|s:E:Rb	1
honte	:hon:te|:§:t	1
brun	br:un:|bR:1:	1
bave	b:a:ve|b:a:v	1
nez	n:ez:|n:e:	1
suinte	su:in:te|s8:5:t	1
nargue	n:a:rgue|n:a:Rg	1
cals	c:a:ls|k:a:l	1
taffe	t:a:ffe|t:a:f	1
ouest	ou:e:st|w:E:st	1
foies	foi:es:|fw:a:	1
poux	p:oux:|p:u:	1
chiffe	ch:i:ffe|S:i:f	1
trempent	tr:em:pent|tR:@:p	1
fève	f:è:ve|f:E:v	1
peines	p:e:ines|p:E:n	1
sexes	s:e:xes|s:E:ks	1
sueurs	su:eur:s|s8:9:R	1
beuh	b:euh:|b:2:	1
souche	s:ou:che|s:u:S	1
graphes	gr:a:phes|gR:a:f	1
sciés	sci:és:|sj:e:	1
guns	g:u:ns|g:9:n	1
guette	g:uet:te|g:E:t	1
tap	t:a:p|t:a:p	1
hart	:har:t|:a:R	1
nable	n:a:ble|n:a:bl	1
groupes	gr:ou:pes|gR:u:p	1
grognes	gr:o:gnes|gR:O:N	1
bondes	b:on:des|b:§:d	1
chiffes	ch:i:ffes|S:i:f	1
courtes	c:ou:rtes|k:u:Rt	1
lottes	l:ot:tes|l:O:t	1
rots	r:o:ts|R:O:t	1
donne	do:n:ne|d:O:n	1
bloques	bl:o:ques|bl:O:k	1
plaire	pl:ai:re|pl:E:R	1
fols	f:o:ls|f:O:l	1
nique	n:i:que|n:i:k	1
siège	si:è:ge|sj:E:Z	1
races	r:a:ces|R:a:s	1
charment	ch:a:rment|S:a:Rm	1
simples	s:i:mples|s:5:pl	1
uht	:uh:t|:y:t	1
socle	s:o:cle|s:O:kl	1
rit	r:it:|R:i:	1
sure	s:u:re|s:y:R	1
masquent	m:a:squent|m:a:sk	1
fraies	fr:aies:|fR:E:	1
aunes	:au:nes|:o:n	1
derche	d:e:rche|d:E:RS	1
bure	b:u:re|b:y:R	1
rions	ri:ons:|Rj:§:	1
galbe	g:a:lbe|g:a:lb	1
bouffes	b:ou:ffes|b:u:f	1
teste	t:e:ste|t:E:st	1
crase	cr:a:se|kR:a:z	1
sors	s:or:s|s:O:R	1
quiets	quie:ts:|kj:E:	1
pilles	p:i:lles|p:i:j	1
none	n:o:ne|n:O:n	1
pound	p:o:und|p:a:wnd	1
tuèrent	tu:è:rent|t8:E:R	1
vitre	v:i:tre|v:i:tR	1
gland	gla:nd:|gl:@:	1
dattes	d:at:tes|d:a:t	1
linges	l:in:ges|l:5:Z	1
parle	p:a:rle|p:a:Rl	1
bride	br:i:de|bR:i:d	1
tînmes	t:în:mes|t:5:m	1
domptent	d:om:ptent|d:§:pt	1
charre	ch:ar:re|S:a:R	1
ring	r:i:ng|R:i:G	1
papes	p:a:pes|p:a:p	1
bangs	b:an:gs|b:@:g	1
kips	k:i:ps|k:i:p	1
bouilles	b:ou:illes|b:u:j	1
bois	boi:s:|bw:a:	1
isthme	:i:sthme|:i:zm	1
pêchent	p:ê:chent|p:E:S	1
class	cl:a:ss|kl:a:s	1
coffre	c:o:ffre|k:O:fR	1
grâces	gr:âc:es|gR:a:s	1
hôtes	:hô:tes|:o:t	1
liât	li:ât:|lj:a:	1
neuves	n:eu:ves|n:9:v	1
prirent	pr:i:rent|pR:i:R	1
maid	m:ai:d|m:E:d	1
fraient	fr:aient:|fR:E:	1
tiques	t:i:ques|t:i:k	1
stère	st:è:re|st:E:R	1
oïl	:o:ïl|:O:jl	1
sphères	sph:è:res|sf:E:R	1
mines	m:i:nes|m:i:n	1
bases	b:a:ses|b:a:z	1
vantes	v:an:tes|v:@:t	1
gourd	g:ou:rd|g:u:R	1
soupent	s:ou:pent|s:u:p	1
kit	k:i:t|k:i:t	1
veux	v:eux:|v:2:	1
blanc	bla:nc:|bl:@:	1
pans	p:ans:|p:@:	1
six	s:i:x|s:i:s	1
laîches	l:aî:ches|l:E:S	1
payes	p:ay:es|p:e:j	1
fêle	f:ê:le|f:E:l	1
seille	s:e:ille|s:E:j	1
briment	br:i:ment|bR:i:m	1
marbres	m:a:rbres|m:a:RbR	1
soigne	so:i:gne|sw:a:N	1
tâtent	t:â:tent|t:a:t	1
cite	c:i:te|s:i:t	1
stase	st:a:se|st:a:z	1
glu	gl:u:|gl:y:	1
nec	n:e:c|n:E:k	1
tende	t:en:de|t:@:d	1
blâme	bl:â:me|bl:a:m	1
mette	m:et:te|m:E:t	1
gare	g:a:re|g:a:R	1
sussent	s:u:ssent|s:y:s	1
cernes	c:e:rnes|s:E:Rn	1
duit	dui:t:|d8:i:	1
four	f:ou:r|f:u:R	1
mât	m:ât:|m:a:	1
gars	g:ars:|g:a:	1
ronfle	r:on:fle|R:§:fl	1
vas	v:as:|v:a:	1
lande	l:an:de|l:@:d	1
terres	t:er:res|t:E:R	1
grottes	gr:ot:tes|gR:O:t	1
fonces	f:on:ces|f:§:s	1
flouve	fl:ou:ve|fl:u:v	1
plombes	pl:om:bes|pl:§:b	1
nul	n:u:l|n:y:l	1
prés	pr:és:|pR:e:	1
blé	bl:é:|bl:e:	1
proches	pr:o:ches|pR:O:S	1
pûtes	p:û:tes|p:y:t	1
frasque	fr:a:sque|fR:a:sk	1
cob	c:o:b|k:O:b	1
soif	so:i:f|sw:a:f	1
poing	poi:ng:|pw:5:	1
corse	c:o:rse|k:O:Rs	1
chiante	chi:an:te|Sj:@:t	1
ode	:o:de|:O:d	1
guise	gu:i:se|g:i:z	1
bleds	bl:e:ds|bl:E:d	1
cherches	ch:e:rches|S:E:RS	1
carde	c:a:rde|k:a:Rd	1
griffent	gr:i:ffent|gR:i:f	1
gays	g:ays:|g:E:	1
cape	c:a:pe|k:a:p	1
cuise	cu:i:se|k8:i:z	1
hon	:hon:|:§:	1
algues	:a:lgues|:a:lg	1
pitres	p:i:tres|p:i:tR	1
fer	f:e:r|f:E:R	1
poste	p:o:ste|p:O:st	1
genre	g:en:re|Z:@:R	1
cuite	cu:i:te|k8:i:t	1
vaine	v:ai:ne|v:E:n	1
bruissent	bru:i:ssent|bR8:i:s	1
pschitt	psch:i:tt|pS:i:t	1
brute	br:u:te|bR:y:t	1
noueuse	nou:eu:se|nw:2:z	1
trime	tr:i:me|tR:i:m	1
plume	pl:u:me|pl:y:m	1
suive	su:i:ve|s8:i:v	1
glousse	gl:ou:sse|gl:u:s	1
duos	du:os:|d8:o:	1
danse	d:an:se|d:@:s	1
turcs	t:u:rcs|t:y:Rk	1
flores	fl:o:res|fl:O:R	1
clopes	cl:o:pes|kl:O:p	1
âcre	:â:cre|:a:kR	1
diable	di:a:ble|dj:a:bl	1
clubs	cl:u:bs|kl:9:b	1
âges	:â:ges|:a:Z	1
niai	ni:ai:|nj:E:	1
bistre	b:i:stre|b:i:stR	1
gère	g:è:re|Z:E:R	1
guêtre	g:uê:tre|g:E:tR	1
ci	c:i:|s:i:	1
bâcle	b:â:cle|b:a:kl	1
marches	m:a:rches|m:a:RS	1
loutre	l:ou:tre|l:u:tR	1
ta	t:a:|t:a:	1
rampes	r:am:pes|R:@:p	1
verte	v:e:rte|v:E:Rt	1
sourdre	s:ou:rdre|s:u:RdR	1
troubles	tr:ou:bles|tR:u:bl	1
chiez	chie:z:|Sj:e:	1
huit	hu:i:t|8:i:t	1
clans	cla:ns:|kl:@:	1
lût	l:ût:|l:y:	1
stocks	st:o:cks|st:O:k	1
fiée	fi:ée:|fj:e:	1
gram	gr:a:m|gR:a:m	1
dès	d:ès:|d:E:	1
seaux	s:eaux:|s:o:	1
sandres	s:an:dres|s:@:dR	1
bonne	bo:n:ne|b:O:n	1
o	:o:|:o:	1
ouïes	ouï:es:|w:i:	1
shoots	sho:o:ts|S:u:t	1
gamme	g:a:mme|g:a:m	1
jupe	j:u:pe|Z:y:p	1
pèsent	p:è:sent|p:E:z	1
geignent	g:e:ignent|Z:E:N	1
ailes	:ai:les|:E:l	1
châsse	ch:â:sse|S:a:s	1
line	l:i:ne|l:i:n	1
saule	s:au:le|s:o:l	1
nuit	nui:t:|n8:i:	1
protes	pr:o:tes|pR:O:t	1
kraal	kr:a:al|kR:a:l	1
ligne	l:i:gne|l:i:N	1
plage	pl:a:ge|pl:a:Z	1
caisse	c:ai:sse|k:E:s	1
gras	gr:as:|gR:a:	1
cygne	c:y:gne|s:i:N	1
mares	m:a:res|m:a:R	1
vînt	v:înt:|v:5:	1
moussent	m:ou:ssent|m:u:s	1
oille	o:i:lle|w:a:j	1
zouk	z:ou:k|z:u:k	1
nia	ni:a:|nj:a:	1
dorent	d:o:rent|d:O:R	1
aune	:au:ne|:o:n	1
preste	pr:e:ste|pR:E:st	1
nièrent	ni:è:rent|nj:E:R	1
mil	m:i:l|m:i:l	1
cours	c:ou:rs|k:u:R	1
tuiles	tu:i:les|t8:i:l	1
scinde	sc:in:de|s:5:d	1
truque	tr:u:que|tR:y:k	1
guident	gu:i:dent|g:i:d	1
celui	celu:i:|sl8:i:	1
labbe	l:a:bbe|l:a:b	1
croisse	cro:i:sse|kRw:a:s	1
moï	m:o:ï|m:O:j	1
plus	pl:us:|pl:y:	1
routes	r:ou:tes|R:u:t	1
flairent	fl:ai:rent|fl:E:R	1
gaufre	g:au:fre|g:o:fR	1
deale	d:ea:le|d:i:l	1
haut	:haut:|:o:	1
joins	joi:ns:|Zw:5:	1
club	cl:u:b|kl:9:b	1
taule	t:au:le|t:o:l	1
bûches	b:û:ches|b:y:S	1
crusses	cr:u:sses|kR:y:s	1
rident	r:i:dent|R:i:d	1
luttes	l:ut:tes|l:y:t	1
ob	:o:b|:O:b	1
foirent	fo:i:rent|fw:a:R	1
enfles	:en:fles|:@:fl	1
crisse	cr:i:sse|kR:i:s	1
lied	li:e:d|l:i:d	1
dicte	d:i:cte|d:i:kt	1
us	:u:s|:y:s	1
frises	fr:i:ses|fR:i:z	1
viennent	vi:en:nent|vj:E:n	1
traque	tr:a:que|tR:a:k	1
et	:et:|:e:	1
rouf	r:ou:f|R:u:f	1
york	y:o:rk|j:O:Rk	1
sir	s:i:r|s:i:R	1
plaines	pl:ai:nes|pl:E:n	1
noce	n:o:ce|n:O:s	1
mal	m:a:l|m:a:l	1
belge	b:e:lge|b:E:lZ	1
centres	c:en:tres|s:@:tR	1
cippes	c:i:ppes|s:i:p	1
binz	b:i:nz|b:i:nz	1
chtourbe	cht:ou:rbe|kt:u:Rb	1
tacle	t:a:cle|t:a:kl	1
poignent	po:i:gnent|pw:a:N	1
cuves	c:u:ves|k:y:v	1
frasques	fr:a:sques|fR:a:sk	1
crispes	cr:i:spes|kR:i:sp	1
torts	t:o:rts|t:O:R	1
nés	n:és:|n:e:	1
glabre	gl:a:bre|gl:a:bR	1
poudres	p:ou:dres|p:u:dR	1
tore	t:o:re|t:O:R	1
freins	fr:eins:|fR:5:	1
veste	v:e:ste|v:E:st	1
ferre	f:er:re|f:E:R	1
faible	f:ai:ble|f:E:bl	1
tienne	ti:en:ne|tj:E:n	1
clique	cl:i:que|kl:i:k	1
priment	pr:i:ment|pR:i:m	1
stoppe	st:o:ppe|st:O:p	1
muent	m:uent:|m:y:	1
deux	d:eux:|d:2:	1
turque	t:u:rque|t:y:Rk	1
frangent	fr:an:gent|fR:@:Z	1
vivent	v:i:vent|v:i:v	1
leurres	l:eur:res|l:9:R	1
couette	cou:et:te|kw:E:t	1
ducs	d:u:cs|d:y:k	1
trench	tr:e:nch|tR:E:nS	1
chies	ch:ies:|S:i:	1
celée	cel:ée:|sl:e:	1
gnaule	gn:au:le|N:o:l	1
sains	s:ains:|s:5:	1
vais	v:ais:|v:E:	1
faune	f:au:ne|f:o:n	1
ort	:or:t|:O:R	1
cibles	c:i:bles|s:i:bl	1
fige	f:i:ge|f:i:Z	1
vergne	v:e:rgne|v:E:RN	1
sautes	s:au:tes|s:o:t	1
stand	st:an:d|st:@:d	1
schème	sch:è:me|S:E:m	1
lunches	l:u:nches|l:9:ntS	1
foute	f:ou:te|f:u:t	1
fuir	fu:i:r|f8:i:R	1
fièvres	fi:è:vres|fj:E:vR	1
phoque	ph:o:que|f:O:k	1
pôle	p:ô:le|p:o:l	1
aux	:aux:|:o:	1
bûchent	b:û:chent|b:y:S	1
dés	d:és:|d:e:	1
erre	:er:re|:E:R	1
brome	br:o:me|bR:o:m	1
rep	r:e:p|R:E:p	1
feu	f:eu:|f:2:	1
serbes	s:e:rbes|s:E:Rb	1
jouer	jou:er:|Zw:e:	1
tardent	t:a:rdent|t:a:Rd	1
phasmes	ph:a:smes|f:a:sm	1
nargues	n:a:rgues|n:a:Rg	1
nuages	nu:a:ges|n8:a:Z	1
lemmes	l:em:mes|l:E:m	1
schmecte	schm:e:cte|Sm:E:kt	1
part	p:a:rt|p:a:R	1
heu	:heu:|:2:	1
aulnes	:au:lnes|:o:ln	1
voués	vou:és:|vw:e:	1
glande	gl:an:de|gl:@:d	1
pliât	pli:ât:|plj:a:	1
fringuent	fr:in:guent|fR:5:g	1
bouées	bou:ées:|bw:e:	1
boche	b:o:che|b:O:S	1
si	s:i:|s:i:	1
dote	d:o:te|d:O:t	1
teindre	te:in:dre|t:5:dR	1
tag	t:a:g|t:a:g	1
braie	br:aie:|bR:E:	1
cancres	c:an:cres|k:@:kR	1
nage	n:a:ge|n:a:Z	1
serre	s:er:re|s:E:R	1
estes	:e:stes|:E:st	1
tues	t:ues:|t:y:	1
suaves	su:a:ves|s8:a:v	1
pognes	p:o:gnes|p:O:N	1
clope	cl:o:pe|kl:O:p	1
bu	b:u:|b:y:	1
reps	r:e:ps|R:E:ps	1
amble	:a:mble|:@:bl	1
mufle	m:u:fle|m:y:fl	1
lauzes	l:au:zes|l:o:z	1
piègent	pi:è:gent|pj:E:Z	1
poigne	po:i:gne|pw:a:N	1
ères	:è:res|:E:R	1
baise	b:ai:se|b:E:z	1
gravent	gr:a:vent|gR:a:v	1
bye	b:y:e|b:a:j	1
jours	j:ou:rs|Z:u:R	1
seilles	s:e:illes|s:E:j	1
scoute	sc:ou:te|sk:u:t	1
liège	li:è:ge|lj:E:Z	1
tempes	t:em:pes|t:@:p	1
sommes	s:om:mes|s:O:m	1
dyke	d:yk:e|d:i:k	1
ru	r:u:|R:y:	1
stop	st:o:p|st:O:p	1
frisent	fr:i:sent|fR:i:z	1
gnouf	gn:ou:f|N:u:f	1
not	n:o:t|n:O:t	1
visent	v:i:sent|v:i:z	1
pals	p:a:ls|p:a:l	1
tchatches	tch:a:tches|tS:a:tS	1
alde	:a:lde|:a:ld	1
clé	cl:é:|kl:e:	1
jauges	j:au:ges|Z:o:Z	1
mod	m:o:d|m:O:d	1
jeune	j:eu:ne|Z:9:n	1
coupent	c:ou:pent|k:u:p	1
sieste	si:e:ste|sj:E:st	1
plain	pla:in:|pl:5:	1
jaugent	j:au:gent|Z:o:Z	1
blêmes	bl:ê:mes|bl:E:m	1
lise	l:i:se|l:i:z	1
sucre	s:u:cre|s:y:kR	1
moufles	m:ou:fles|m:u:fl	1
toges	t:o:ges|t:O:Z	1
blanque	bl:an:que|bl:@:k	1
twill	tw:i:ll|tw:i:l	1
fards	f:a:rds|f:a:R	1
lien	lie:n:|lj:5:	1
seiche	s:ei:che|s:E:S	1
plaque	pl:a:que|pl:a:k	1
tués	tu:és:|t8:e:	1
barque	b:a:rque|b:a:Rk	1
fugues	f:u:gues|f:y:g	1
mare	m:a:re|m:a:R	1
russe	r:u:sse|R:y:s	1
rostre	r:o:stre|R:O:stR	1
skiff	sk:i:ff|sk:i:f	1
havre	:ha:vre|:a:vR	1
craillent	cr:a:illent|kR:a:j	1
crawl	cr:aw:l|kR:o:l	1
vers	v:e:rs|v:E:R	1
rythme	r:yt:hme|R:i:tm	1
gorges	g:o:rges|g:O:RZ	1
suée	su:ée:|s8:e:	1
scalpe	sc:a:lpe|sk:a:lp	1
mont	m:ont:|m:§:	1
mess	m:e:ss|m:E:s	1
fripes	fr:i:pes|fR:i:p	1
tan	t:an:|t:@:	1
joueuse	jou:eu:se|Zw:2:z	1
prête	pr:ê:te|pR:E:t	1
sures	s:u:res|s:y:R	1
partes	p:a:rtes|p:a:Rt	1
scripte	scr:i:pte|skR:i:pt	1
lad	l:a:d|l:a:d	1
flashent	fla:s:hent|fl:a:S	1
rames	r:a:mes|R:a:m	1
lobes	l:o:bes|l:O:b	1
nouant	nou:ant:|nw:@:	1
bridgent	br:i:dgent|bR:i:dZ	1
rangent	r:an:gent|R:@:Z	1
verres	v:er:res|v:E:R	1
fèces	f:èc:es|f:E:s	1
vende	v:en:de|v:@:d	1
shed	sh:e:d|S:E:d	1
mondes	m:on:des|m:§:d	1
goitres	go:i:tres|gw:a:tR	1
gis	g:is:|Z:i:	1
aides	:ai:des|:E:d	1
bouffe	b:ou:ffe|b:u:f	1
miasme	mi:a:sme|mj:a:sm	1
lices	l:i:ces|l:i:s	1
lobs	l:o:bs|l:O:b	1
pertes	p:e:rtes|p:E:Rt	1
chrême	chr:ê:me|kR:E:m	1
faites	f:ai:tes|f:E:t	1
linge	l:in:ge|l:5:Z	1
char	ch:a:r|S:a:R	1
plantent	pl:an:tent|pl:@:t	1
lige	l:i:ge|l:i:Z	1
plaquent	pl:a:quent|pl:a:k	1
trêves	tr:ê:ves|tR:E:v	1
or	:o:r|:O:R	1
dogme	d:o:gme|d:O:gm	1
sectes	s:e:ctes|s:E:kt	1
nombres	n:om:bres|n:§:bR	1
dogues	d:o:gues|d:O:g	1
passes	p:a:sses|p:a:s	1
off	:o:ff|:O:f	1
louait	lou:ait:|lw:E:	1
goinfres	go:in:fres|gw:5:fR	1
bôme	b:ô:me|b:o:m	1
pieuvres	pi:eu:vres|pj:9:vR	1
cercle	c:e:rcle|s:E:Rkl	1
fau	f:au:|f:o:	1
guelfes	gu:e:lfes|g:E:lf	1
maures	m:au:res|m:o:R	1
soit	soi:t:|sw:a:	1
casent	c:a:sent|k:a:z	1
goinfrent	go:in:frent|gw:5:fR	1
tiquent	t:i:quent|t:i:k	1
lèpre	l:è:pre|l:E:pR	1
liés	li:és:|lj:e:	1
change	ch:an:ge|S:@:Z	1
brol	br:o:l|bR:O:l	1
clochent	cl:o:chent|kl:O:S	1
gouape	gou:a:pe|gw:a:p	1
touchent	t:ou:chent|t:u:S	1
secs	s:e:cs|s:E:k	1
chèvre	ch:è:vre|S:E:vR	1
ceignent	c:e:ignent|s:E:N	1
suées	su:ées:|s8:e:	1
île	:î:le|:i:l	1
se	s:e:|s:2:	1
vestes	v:e:stes|v:E:st	1
fibre	f:i:bre|f:i:bR	1
souhaite	sou:hai:te|sw:E:t	1
gausse	g:au:sse|g:o:s	1
socque	s:oc:que|s:O:k	1
tué	tu:é:|t8:e:	1
cousent	c:ou:sent|k:u:z	1
rôles	r:ô:les|R:o:l	1
flippe	fl:i:ppe|fl:i:p	1
couvre	c:ou:vre|k:u:vR	1
branchent	br:an:chent|bR:@:S	1
crève	cr:è:ve|kR:E:v	1
type	t:y:pe|t:i:p	1
cote	c:o:te|k:O:t	1
prude	pr:u:de|pR:y:d	1
coiffent	coi:f:fent|kw:a:f	1
laîche	l:aî:che|l:E:S	1
morgues	m:o:rgues|m:O:Rg	1
sabres	s:a:bres|s:a:bR	1
serai	ser:ai:|sR:E:	1
formes	f:o:rmes|f:O:Rm	1
pleut	pl:eut:|pl:2:	1
bruns	br:uns:|bR:1:	1
nome	n:o:me|n:O:m	1
cil	c:i:l|s:i:l	1
phares	ph:a:res|f:a:R	1
sises	s:i:ses|s:i:z	1
happent	:hap:pent|:a:p	1
perde	p:e:rde|p:E:Rd	1
meurt	m:eur:t|m:9:R	1
goût	g:oût:|g:u:	1
targe	t:a:rge|t:a:RZ	1
eussent	:eu:ssent|:y:s	1
flèche	fl:è:che|fl:E:S	1
larves	l:a:rves|l:a:Rv	1
daignes	d:ai:gnes|d:E:N	1
nous	n:ous:|n:u:	1
ample	:am:ple|:@:pl	1
putes	p:u:tes|p:y:t	1
darde	d:a:rde|d:a:Rd	1
châle	ch:â:le|S:a:l	1
grimpent	gr:im:pent|gR:5:p	1
rites	r:i:tes|R:i:t	1
schnouffe	schn:ou:ffe|Sn:u:f	1
mène	m:è:ne|m:E:n	1
tuile	tu:i:le|t8:i:l	1
gueulent	gu:eu:lent|g:9:l	1
bip	b:i:p|b:i:p	1
sangs	s:angs:|s:@:	1
fan	f:a:n|f:a:n	1
boueur	bou:eu:r|bw:9:R	1
les	l:es:|l:e:	1
vouées	vou:ées:|vw:e:	1
gouaille	gou:a:ille|gw:a:j	1
dette	d:et:te|d:E:t	1
squeezent	sque:e:zent|skw:i:z	1
tchèques	tch:è:ques|tS:E:k	1
blés	bl:és:|bl:e:	1
bit	b:i:t|b:i:t	1
jouait	jou:ait:|Zw:E:	1
galle	g:al:le|g:a:l	1
gaule	g:au:le|g:o:l	1
lèche	l:è:che|l:E:S	1
blet	bl:et:|bl:E:	1
stalle	st:al:le|st:a:l	1
presque	pr:e:sque|pR:E:sk	1
suaient	su:aient:|s8:E:	1
loirs	loi:r:s|lw:a:R	1
quarte	qu:a:rte|k:a:Rt	1
jais	j:ais:|Z:E:	1
troupes	tr:ou:pes|tR:u:p	1
hardent	:ha:rdent|:a:Rd	1
poêles	po:ê:les|pw:a:l	1
glabres	gl:a:bres|gl:a:bR	1
doit	doi:t:|dw:a:	1
loueurs	lou:eur:s|lw:9:R	1
larde	l:a:rde|l:a:Rd	1
lotte	l:ot:te|l:O:t	1
guettent	g:uet:tent|g:E:t	1
bettes	b:et:tes|b:E:t	1
danses	d:an:ses|d:@:s	1
oit	oi:t:|w:a:	1
shunt	sh:u:nt|S:9:nt	1
aile	:ai:le|:E:l	1
dèmes	d:è:mes|d:E:m	1
lieu	lie:u:|lj:2:	1
riants	ria:nts:|Rj:@:	1
macres	m:a:cres|m:a:kR	1
chappe	ch:a:ppe|S:a:p	1
voeux	vo:eux:|v:2:	1
pacte	p:a:cte|p:a:kt	1
longe	l:on:ge|l:§:Z	1
drags	dr:a:gs|dR:a:g	1
triste	tr:i:ste|tR:i:st	1
loupes	l:ou:pes|l:u:p	1
tes	t:es:|t:e:	1
chut	ch:ut:|S:y:	1
gorgent	g:o:rgent|g:O:RZ	1
strophes	str:o:phes|stR:O:f	1
groume	gr:ou:me|gR:u:m	1
craints	cr:aints:|kR:5:	1
serons	ser:ons:|sR:§:	1
pleutre	pl:eu:tre|pl:2:tR	1
zobs	z:o:bs|z:O:b	1
ions	i:ons:|j:§:	1
douche	d:ou:che|d:u:S	1
liai	li:ai:|lj:E:	1
lente	l:en:te|l:@:t	1
fa	f:a:|f:a:	1
vielles	vie:l:les|vj:E:l	1
boudent	b:ou:dent|b:u:d	1
figue	f:i:gue|f:i:g	1
guimpes	g:uim:pes|g:5:p	1
rirent	r:i:rent|R:i:R	1
hue	:hue:|:y:	1
hases	:ha:ses|:a:z	1
lutz	l:u:tz|l:y:ts	1
groupe	gr:ou:pe|gR:u:p	1
pendre	p:en:dre|p:@:dR	1
brasses	br:a:sses|bR:a:s	1
bique	b:i:que|b:i:k	1
parles	p:a:rles|p:a:Rl	1
foule	f:ou:le|f:u:l	1
trombe	tr:om:be|tR:§:b	1
pêne	p:ê:ne|p:E:n	1
beur	b:eu:r|b:9:R	1
sceaux	s:ceaux:|s:o:	1
somment	s:om:ment|s:O:m	1
duc	d:u:c|d:y:k	1
lies	l:ies:|l:i:	1
lavent	l:a:vent|l:a:v	1
plaigne	pl:ai:gne|pl:E:N	1
darce	d:a:rce|d:a:Rs	1
causes	c:au:ses|k:o:z	1
vouai	vou:ai:|vw:E:	1
gaves	g:a:ves|g:a:v	1
flat	fla:t:|fl:a:	1
tape	t:a:pe|t:a:p	1
ra	r:a:|R:a:	1
lurent	l:u:rent|l:y:R	1
bourres	b:our:res|b:u:R	1
caps	c:a:ps|k:a:p	1
moquent	m:o:quent|m:O:k	1
sports	sp:o:rts|sp:O:R	1
cloîtres	clo:î:tres|klw:a:tR	1
boules	b:ou:les|b:u:l	1
rues	r:ues:|R:y:	1
francs	fr:ancs:|fR:@:	1
miels	mi:e:ls|mj:E:l	1
bords	b:o:rds|b:O:R	1
franc	fr:anc:|fR:@:	1
contres	c:on:tres|k:§:tR	1
tâches	t:â:ches|t:a:S	1
trouilles	tr:ou:illes|tR:u:j	1
dams	d:ams:|d:@:	1
clore	cl:o:re|kl:O:R	1
bipes	b:i:pes|b:i:p	1
penne	p:en:ne|p:E:n	1
sot	s:ot:|s:o:	1
ruelle	ru:el:le|R8:E:l	1
foudre	f:ou:dre|f:u:dR	1
louchent	l:ou:chent|l:u:S	1
aimes	:ai:mes|:E:m	1
hués	hu:és:|8:e:	1
chics	ch:i:cs|S:i:k	1
êtres	:ê:tres|:E:tR	1
brunches	br:u:nches|bR:9:nS	1
glyphes	glyph:e:s|gl:i:f	1
ceint	ce:int:|s:5:	1
thèse	t:hè:se|t:E:z	1
borchtch	b:o:rchtch|b:O:RtS	1
foutes	f:ou:tes|f:u:t	1
schistes	sch:i:stes|S:i:st	1
hautes	:hau:tes|:o:t	1
nacres	n:a:cres|n:a:kR	1
sciez	scie:z:|sj:e:	1
bien	bie:n:|bj:5:	1
meus	m:eus:|m:2:	1
coke	co:k:e|k:o:k	1
grolle	gr:ol:le|gR:O:l	1
bin's	b:i:n's|b:i:ns	1
malt	m:a:lt|m:a:lt	1
spectres	sp:e:ctres|sp:E:ktR	1
dues	d:ues:|d:y:	1
pleurent	pl:eu:rent|pl:9:R	1
gueuze	g:ueu:ze|g:2:z	1
buires	bu:i:res|b8:i:R	1
dinde	d:in:de|d:5:d	1
oye	o:ye:|w:a:	1
est	:est:|:e:	1
tètent	t:è:tent|t:E:t	1
nil	n:i:l|n:i:l	1
prudes	pr:u:des|pR:y:d	1
foins	foi:ns:|fw:5:	1
ose	:o:se|:o:z	1
gênent	g:ê:nent|Z:E:n	1
plissent	pl:i:ssent|pl:i:s	1
punchs	p:u:nchs|p:9:nS	1
deales	d:ea:les|d:i:l	1
graff	gr:a:ff|gR:a:f	1
cites	c:i:tes|s:i:t	1
scalp	sc:a:lp|sk:a:lp	1
mises	m:i:ses|m:i:z	1
marges	m:a:rges|m:a:RZ	1
temples	t:e:mples|t:@:pl	1
torche	t:o:rche|t:O:RS	1
moufle	m:ou:fle|m:u:fl	1
kilts	k:i:lts|k:i:lt	1
feint	f:eint:|f:5:	1
cafte	c:a:fte|k:a:ft	1
nègre	n:è:gre|n:E:gR	1
timbres	t:i:mbres|t:5:bR	1
friche	fr:i:che|fR:i:S	1
grosse	gr:o:sse|gR:o:s	1
croix	croi:x:|kRw:a:	1
skip	sk:i:p|sk:i:p	1
sniffes	sn:i:ffes|sn:i:f	1
skies	sk:ies:|sk:i:	1
trompes	tr:om:pes|tR:§:p	1
spires	sp:i:res|sp:i:R	1
nié	ni:é:|nj:e:	1
rai	r:ai:|R:E:	1
kiosque	ki:o:sque|kj:O:sk	1
oncles	:on:cles|:§:kl	1
votes	v:o:tes|v:O:t	1
mattes	ma:t:tes|m:a:t	1
cop	c:o:p|k:O:p	1
os	:o:s|:O:s	1
cuises	cu:i:ses|k8:i:z	1
choppent	ch:op:pent|S:O:p	1
pagnes	p:a:gnes|p:a:N	1
crée	cr:ée:|kR:e:	1
siècles	si:è:cles|sj:E:kl	1
nonne	no:n:ne|n:O:n	1
laudes	l:au:des|l:o:d	1
croise	croi:s:e|kRw:a:z	1
pics	p:i:cs|p:i:k	1
singe	s:in:ge|s:5:Z	1
syrtes	s:y:rtes|s:i:Rt	1
noirs	noi:r:s|nw:a:R	1
cab	c:a:b|k:a:b	1
mien	mie:n:|mj:5:	1
chuinte	chu:in:te|S8:5:t	1
jarre	j:ar:re|Z:a:R	1
plains	pla:ins:|pl:5:	1
aient	:aient:|:E:	1
barges	b:a:rges|b:a:RZ	1
couvent	c:ou:vent|k:u:v	1
frustes	fr:u:stes|fR:y:st	1
coule	c:ou:le|k:u:l	1
palpe	p:a:lpe|p:a:lp	1
saut	s:aut:|s:o:	1
boueux	bou:eux:|bw:2:	1
fresque	fr:e:sque|fR:E:sk	1
quark	qu:a:rk|kw:a:Rk	1
pince	p:in:ce|p:5:s	1
schpile	schp:i:le|Sp:i:l	1
pasque	p:a:sque|p:a:sk	1
modes	m:o:des|m:O:d	1
field	fi:e:ld|f:i:ld	1
carguent	c:a:rguent|k:a:Rg	1
ans	:ans:|:@:	1
graille	gr:a:ille|gR:a:j	1
lut	l:ut:|l:y:	1
viable	vi:a:ble|vj:a:bl	1
cher	ch:e:r|S:E:R	1
flashe	fla:s:he|fl:a:S	1
hâtes	:hâ:tes|:a:t	1
tongs	t:on:gs|t:§:g	1
psy	ps:y:|ps:i:	1
crânent	cr:â:nent|kR:a:n	1
sotte	s:ot:te|s:O:t	1
pionce	pi:on:ce|pj:§:s	1
dèche	d:è:che|d:E:S	1
brusque	br:u:sque|bR:y:sk	1
ré	r:é:|R:e:	1
lyres	l:y:res|l:i:R	1
liage	li:a:ge|lj:a:Z	1
onces	:onc:es|:§:s	1
gnose	gn:o:se|gn:o:z	1
crabs	cr:a:bs|kR:a:bs	1
toué	tou:é:|tw:e:	1
schuss	sch:u:ss|S:u:s	1
puff	p:u:ff|p:9:f	1
loue	l:oue:|l:u:	1
chibre	ch:i:bre|S:i:bR	1
hot	:ho:t|:O:t	1
ceintes	ce:in:tes|s:5:t	1
cols	c:o:ls|k:O:l	1
chiffrent	ch:i:ffrent|S:i:fR	1
sarcle	s:a:rcle|s:a:Rkl	1
rapts	r:a:pts|R:a:pt	1
chieuse	chie:u:se|Sj:2:z	1
nuées	nu:ées:|n8:e:	1
quelque	qu:e:lque|k:E:lk	1
germes	g:e:rmes|Z:E:Rm	1
drift	dr:i:ft|dR:i:ft	1
veuf	v:eu:f|v:9:f	1
grattes	gr:at:tes|gR:a:t	1
centre	c:en:tre|s:@:tR	1
brutes	br:u:tes|bR:y:t	1
dictent	d:i:ctent|d:i:kt	1
lueurs	lu:eur:s|l8:9:R	1
schnick	schn:i:ck|Sn:i:k	1
boer	bo:e:r|b:9:R	1
âge	:â:ge|:a:Z	1
rôdes	r:ô:des|R:o:d	1
nid	n:id:|n:i:	1
rafles	r:a:fles|R:a:fl	1
saxes	s:a:xes|s:a:ks	1
pluches	pl:u:ches|pl:y:S	1
dache	d:a:che|d:a:S	1
roua	rou:a:|Rw:a:	1
dîme	d:î:me|d:i:m	1
yin	y:i:n|j:i:n	1
quatre	qu:a:tre|k:a:tR	1
ruais	ru:ais:|R8:E:	1
nième	ni:è:me|nj:E:m	1
lieux	lie:ux:|lj:2:	1
cloue	cl:oue:|kl:u:	1
luise	lu:i:se|l8:i:z	1
cerfs	c:e:rfs|s:E:R	1
cerf	c:e:rf|s:E:R	1
dosent	d:o:sent|d:o:z	1
beu	b:eu:|b:2:	1
huppe	:hup:pe|:y:p	1
champs	ch:amps:|S:@:	1
hydre	:hy:dre|:i:dR	1
vans	v:a:ns|v:a:n	1
lia	li:a:|lj:a:	1
aulne	:au:lne|:o:ln	1
râble	r:â:ble|R:a:bl	1
nasses	n:a:sses|n:a:s	1
blairs	bl:ai:rs|bl:E:R	1
guettes	g:uet:tes|g:E:t	1
mouftent	m:ou:ftent|m:u:ft	1
pur	p:u:r|p:y:R	1
scratch	scr:a:tch|skR:a:tS	1
galles	g:al:les|g:a:l	1
vigne	v:i:gne|v:i:N	1
fours	f:ou:rs|f:u:R	1
swing	sw:i:ng|sw:i:G	1
pâtres	p:â:tres|p:a:tR	1
scirpes	sc:i:rpes|s:i:Rp	1
greffent	gr:e:ffent|gR:E:f	1
flippes	fl:i:ppes|fl:i:p	1
motte	mo:t:te|m:O:t	1
poutres	p:ou:tres|p:u:tR	1
svelte	sv:e:lte|sv:E:lt	1
rag	r:a:g|R:a:g	1
sciaient	sci:aient:|sj:E:	1
bronze	br:on:ze|bR:§:z	1
snack	sn:a:ck|sn:a:k	1
bref	br:e:f|bR:E:f	1
sondent	s:on:dent|s:§:d	1
bourges	b:ou:rges|b:u:RZ	1
quai	qu:ai:|k:E:	1
proue	pr:oue:|pR:u:	1
flingues	fl:in:gues|fl:5:g	1
béent	b:éent:|b:e:	1
neuve	n:eu:ve|n:9:v	1
branles	br:an:les|bR:@:l	1
flaque	fl:a:que|fl:a:k	1
neufs	n:eu:fs|n:9:f	1
salves	s:a:lves|s:a:lv	1
myste	m:y:ste|m:i:st	1
fuies	fui:es:|f8:i:	1
beaux	b:eaux:|b:o:	1
croquent	cr:o:quent|kR:O:k	1
onde	:on:de|:§:d	1
nard	n:a:rd|n:a:R	1
brosse	br:o:sse|bR:O:s	1
bulbe	b:u:lbe|b:y:lb	1
ongles	:on:gles|:§:gl	1
crie	cr:ie:|kR:i:	1
suces	s:u:ces|s:y:s	1
blette	bl:et:te|bl:E:t	1
deuils	d:eu:ils|d:9:j	1
short	sh:o:rt|S:O:Rt	1
fringues	fr:in:gues|fR:5:g	1
faussent	f:au:ssent|f:o:s	1
potes	p:o:tes|p:O:t	1
morfles	m:o:rfles|m:O:Rfl	1
naissent	n:ai:ssent|n:E:s	1
bourgs	b:ou:rgs|b:u:R	1
chantes	ch:an:tes|S:@:t	1
hachent	:ha:chent|:a:S	1
pèlent	p:è:lent|p:E:l	1
reines	r:e:ines|R:E:n	1
filent	f:i:lent|f:i:l	1
briefes	br:i:efes|bR:i:f	1
crus	cr:us:|kR:y:	1
jouirent	jou:i:rent|Zw:i:R	1
gal	g:a:l|g:a:l	1
puce	p:u:ce|p:y:s	1
caille	c:a:ille|k:a:j	1
fourches	f:ou:rches|f:u:RS	1
dûmes	d:û:mes|d:y:m	1
serves	s:e:rves|s:E:Rv	1
robe	r:o:be|R:O:b	1
pi	p:i:|p:i:	1
rua	ru:a:|R8:a:	1
gours	g:ou:rs|g:u:R	1
bock	b:o:ck|b:O:k	1
chleuh	chl:euh:|Sl:2:	1
teintent	te:in:tent|t:5:t	1
tringle	tr:in:gle|tR:5:gl	1
fjord	fj:o:rd|fj:O:Rd	1
rials	ri:a:ls|Rj:a:l	1
isme	:i:sme|:i:sm	1
louant	lou:ant:|lw:@:	1
guises	gu:i:ses|g:i:z	1
chlingue	chl:in:gue|Sl:5:g	1
lime	l:i:me|l:i:m	1
geins	ge:ins:|Z:5:	1
pâtre	p:â:tre|p:a:tR	1
tueurs	tu:eur:s|t8:9:R	1
douars	dou:a:rs|dw:a:R	1
steppes	st:e:ppes|st:E:p	1
voguent	v:o:guent|v:O:g	1
prime	pr:i:me|pR:i:m	1
traînes	tr:aî:nes|tR:E:n	1
chauffent	ch:au:ffent|S:o:f	1
buée	bu:ée:|b8:e:	1
peine	p:e:ine|p:E:n	1
wax	w:a:x|w:a:ks	1
rut	r:u:t|R:y:t	1
aide	:ai:de|:E:d	1
home	:ho:me|:o:m	1
vinsse	v:in:sse|v:5:s	1
krak	kr:a:k|kR:a:k	1
mille	m:il:le|m:i:l	1
baffe	b:a:ffe|b:a:f	1
arche	:a:rche|:a:RS	1
couple	c:ou:ple|k:u:pl	1
ran	r:an:|R:@:	1
pouh	p:ouh:|p:u:	1
tirent	t:i:rent|t:i:R	1
hument	:hu:ment|:y:m	1
net	n:e:t|n:E:t	1
singles	s:in:gles|s:5:gl	1
macs	m:a:cs|m:a:k	1
frousses	fr:ou:sses|fR:u:s	1
bruits	brui:ts:|bR8:i:	1
matte	ma:t:te|m:a:t	1
lovent	l:o:vent|l:O:v	1
sciure	sci:u:re|sj:y:R	1
couaille	cou:a:ille|kw:a:j	1
giclent	g:i:clent|Z:i:kl	1
jouée	jou:ée:|Zw:e:	1
rythment	r:yt:hment|R:i:tm	1
yacks	y:a:cks|j:a:k	1
long	lo:ng:|l:§:	1
givres	g:i:vres|Z:i:vR	1
slows	sl:ows:|sl:o:	1
clôt	cl:ôt:|kl:o:	1
trusts	tr:u:sts|tR:9:st	1
suer	su:er:|s8:e:	1
airs	:air:s|:E:R	1
suais	su:ais:|s8:E:	1
chleuhs	chl:euhs:|Sl:2:	1
foëne	fo:ë:ne|fw:E:n	1
rosse	r:o:sse|R:O:s	1
chipe	ch:i:pe|S:i:p	1
souillent	s:ou:illent|s:u:j	1
soifs	soi:f:s|sw:a:f	1
tuai	tu:ai:|t8:E:	1
cède	c:è:de|s:E:d	1
stout	st:ou:t|st:u:t	1
luisent	lu:i:sent|l8:i:z	1
drums	dr:u:ms|dR:9:m	1
trois	troi:s:|tRw:a:	1
marbrent	m:a:rbrent|m:a:RbR	1
laizes	laiz:e:s|l:E:z	1
guignes	gu:i:gnes|g:i:N	1
crêpes	cr:ê:pes|kR:E:p	1
mixte	m:i:xte|m:i:kst	1
bru	br:u:|bR:y:	1
signent	s:i:gnent|s:i:N	1
gâtes	g:â:tes|g:a:t	1
barre	b:ar:re|b:a:R	1
bush	b:u:sh|b:u:S	1
plis	pl:is:|pl:i:	1
font	f:ont:|f:§:	1
ton	t:on:|t:§:	1
daignent	d:ai:gnent|d:E:N	1
ports	p:o:rts|p:O:R	1
bague	b:a:gue|b:a:g	1
corps	c:or:ps|k:O:R	1
toux	t:oux:|t:u:	1
hep	:he:p|:E:p	1
but	b:u:t|b:y:t	1
mute	m:u:te|m:y:t	1
fouies	fou:ies:|fw:i:	1
dong	d:on:g|d:§:g	1
grisent	gr:i:sent|gR:i:z	1
pleures	pl:eu:res|pl:9:R	1
prîmes	pr:î:mes|pR:i:m	1
tronches	tr:on:ches|tR:§:S	1
pètes	p:è:tes|p:E:t	1
brade	br:a:de|bR:a:d	1
ruelles	ru:el:les|R8:E:l	1
vaincs	va:in:cs|v:5:k	1
pique	p:i:que|p:i:k	1
mages	m:a:ges|m:a:Z	1
new	n:e:w|n:u:w	1
pagne	p:a:gne|p:a:N	1
baste	b:a:ste|b:a:st	1
tremble	tr:e:mble|tR:@:bl	1
foutre	f:ou:tre|f:u:tR	1
paies	p:aies:|p:E:	1
matent	m:a:tent|m:a:t	1
darses	d:a:rses|d:a:Rs	1
couvrent	c:ou:vrent|k:u:vR	1
grinche	gr:in:che|gR:5:S	1
large	l:a:rge|l:a:RZ	1
pâme	p:â:me|p:a:m	1
heurt	:heur:t|:9:R	1
son	s:on:|s:§:	1
ointe	o:in:te|w:5:t	1
rat	ra:t:|R:a:	1
peindre	pe:in:dre|p:5:dR	1
gante	g:an:te|g:@:t	1
disques	d:i:sques|d:i:sk	1
lutte	l:ut:te|l:y:t	1
fouettes	fou:et:tes|fw:E:t	1
brodent	br:o:dent|bR:O:d	1
cri	cr:i:|kR:i:	1
ankh	:an:kh|:@:k	1
baignent	b:ai:gnent|b:E:N	1
mode	m:o:de|m:O:d	1
game	g:a:me|g:a:m	1
fonte	f:on:te|f:§:t	1
brusques	br:u:sques|bR:y:sk	1
mac	m:a:c|m:a:k	1
morts	m:o:rts|m:O:R	1
creeks	cr:e:eks|kR:i:k	1
clathres	cl:a:thres|kl:a:tR	1
orgue	:o:rgue|:O:Rg	1
noix	noi:x:|nw:a:	1
coinces	coi:nc:es|kw:5:s	1
muets	mu:ets:|m8:E:	1
courses	c:ou:rses|k:u:Rs	1
prisent	pr:i:sent|pR:i:z	1
vesce	v:es:ce|v:E:s	1
châtre	ch:â:tre|S:a:tR	1
flash	fl:a:sh|fl:a:S	1
cuits	cui:ts:|k8:i:	1
keuf	k:eu:f|k:9:f	1
songe	s:on:ge|s:§:Z	1
grippes	gr:i:ppes|gR:i:p	1
floche	fl:o:che|fl:O:S	1
skieuse	skie:u:se|skj:2:z	1
nitre	n:i:tre|n:i:tR	1
vain	va:in:|v:5:	1
bougre	b:ou:gre|b:u:gR	1
miches	m:i:ches|m:i:S	1
raie	r:aie:|R:E:	1
souk	s:ou:k|s:u:k	1
raides	r:ai:des|R:E:d	1
gestes	g:e:stes|Z:E:st	1
gouapes	gou:a:pes|gw:a:p	1
klebs	kl:e:bs|kl:E:ps	1
maths	m:a:ths|m:a:t	1
plats	pla:ts:|pl:a:	1
arrhes	:arrh:es|:a:R	1
pulque	p:u:lque|p:y:lk	1
maintes	ma:in:tes|m:5:t	1
portent	p:o:rtent|p:O:Rt	1
badge	b:a:dge|b:a:dZ	1
pondent	p:on:dent|p:§:d	1
sucent	s:uc:ent|s:y:s	1
lai	l:ai:|l:E:	1
puzzle	p:u:zzle|p:9:zl	1
tordre	t:o:rdre|t:O:RdR	1
box	b:o:x|b:O:ks	1
clairs	cl:ai:rs|kl:E:R	1
cônes	c:ô:nes|k:o:n	1
quimpe	qu:im:pe|k:5:p	1
cèpes	c:è:pes|s:E:p	1
prendre	pr:en:dre|pR:@:dR	1
rinces	r:in:ces|R:5:s	1
vil	v:i:l|v:i:l	1
scrutent	scr:u:tent|skR:y:t	1
gaulle	g:aul:le|g:o:l	1
dingue	d:in:gue|d:5:g	1
fière	fi:è:re|fj:E:R	1
ou	:ou:|:u:	1
bugne	b:u:gne|b:y:N	1
hâte	:hâ:te|:a:t	1
mes	m:es:|m:e:	1
oncle	:on:cle|:§:kl	1
drives	dr:i:ves|dR:i:v	1
slash	sl:a:sh|sl:a:S	1
claire	cl:ai:re|kl:E:R	1
tram	tr:a:m|tR:a:m	1
fun	f:u:n|f:y:n	1
fulls	f:u:lls|f:u:l	1
stances	st:an:ces|st:@:s	1
sous	s:ous:|s:u:	1
hoches	:ho:ches|:O:S	1
clef	cl:ef:|kl:e:	1
mitres	m:i:tres|m:i:tR	1
grog	gr:o:g|gR:O:g	1
iode	i:o:de|j:O:d	1
brèche	br:è:che|bR:E:S	1
touille	t:ou:ille|t:u:j	1
plet	pl:et:|pl:E:	1
rusent	r:u:sent|R:y:z	1
faux	f:aux:|f:o:	1
loueur	lou:eu:r|lw:9:R	1
pouffent	p:ou:ffent|p:u:f	1
tierces	ti:e:rces|tj:E:Rs	1
glide	gl:i:de|gl:i:d	1
fouaille	fou:a:ille|fw:a:j	1
fracs	fr:a:cs|fR:a:k	1
banche	b:an:che|b:@:S	1
geindre	ge:in:dre|Z:5:dR	1
grades	gr:a:des|gR:a:d	1
dring	dr:i:ng|dR:i:G	1
lombes	l:om:bes|l:§:b	1
groupent	gr:ou:pent|gR:u:p	1
scrabble	scr:a:bble|skR:a:bl	1
back	b:a:ck|b:a:k	1
pouces	p:ou:ces|p:u:s	1
crabe	cr:a:be|kR:a:b	1
gâche	g:â:che|g:a:S	1
ailles	:a:illes|:a:j	1
clenche	cl:en:che|kl:@:S	1
dites	d:i:tes|d:i:t	1
lofts	l:o:fts|l:O:f	1
rostres	r:o:stres|R:O:stR	1
scotchs	sc:o:tchs|sk:O:tS	1
ranchs	r:an:chs|R:@:tS	1
titre	t:i:tre|t:i:tR	1
brument	br:u:ment|bR:y:m	1
celtes	c:e:ltes|s:E:lt	1
lors	l:or:s|l:O:R	1
teints	t:eints:|t:5:	1
loué	lou:é:|lw:e:	1
till	t:i:ll|t:i:l	1
sprat	spr:a:t|spR:a:t	1
ram	r:a:m|R:a:m	1
fagnes	f:a:gnes|f:a:N	1
yourtes	y:ou:rtes|j:u:Rt	1
lords	l:o:rds|l:O:Rdz	1
mules	m:u:les|m:y:l	1
plaignent	pl:ai:gnent|pl:E:N	1
rompent	r:om:pent|R:§:p	1
soi	so:i:|sw:a:	1
ion	i:on:|j:§:	1
pouic	pou:i:c|pw:i:k	1
clamse	cl:a:mse|kl:a:ms	1
gagnent	g:a:gnent|g:a:N	1
cash	c:a:sh|k:a:S	1
pieute	pie:u:te|pj:2:t	1
scotches	sc:o:tches|sk:O:tS	1
gourde	g:ou:rde|g:u:Rd	1
maires	m:ai:res|m:E:R	1
boule	b:ou:le|b:u:l	1
saigne	s:ai:gne|s:E:N	1
mine	m:i:ne|m:i:n	1
mordent	m:o:rdent|m:O:Rd	1
crack	cr:a:ck|kR:a:k	1
fouillent	f:ou:illent|f:u:j	1
ils	:il:s|:i:l	1
aigle	:ai:gle|:E:gl	1
pic	p:i:c|p:i:k	1
treille	tr:e:ille|tR:E:j	1
enfle	:en:fle|:@:fl	1
preuve	pr:eu:ve|pR:9:v	1
trek	tr:e:k|tR:E:k	1
laissent	l:ai:ssent|l:E:s	1
crimes	cr:i:mes|kR:i:m	1
dire	d:i:re|d:i:R	1
vires	v:i:res|v:i:R	1
ains	:ain:s|:5:s	1
grimes	gr:i:mes|gR:i:m	1
crans	cr:ans:|kR:@:	1
soue	s:oue:|s:u:	1
juche	j:u:che|Z:y:S	1
rabe	r:a:be|R:a:b	1
rade	r:a:de|R:a:d	1
bâille	b:â:ille|b:a:j	1
voiles	vo:i:les|vw:a:l	1
fate	f:a:te|f:a:t	1
gniard	gni:a:rd|N:a:R	1
ruons	ru:ons:|R8:§:	1
skiffs	sk:i:ffs|sk:i:f	1
cires	c:i:res|s:i:R	1
lierres	li:er:res|lj:E:R	1
goinfre	go:in:fre|gw:5:fR	1
fourmes	f:ou:rmes|f:u:Rm	1
pampre	p:am:pre|p:@:pR	1
chiales	chi:a:les|Sj:a:l	1
banques	b:an:ques|b:@:k	1
liaient	li:aient:|lj:E:	1
rote	r:o:te|R:O:t	1
nems	n:e:ms|n:E:m	1
liants	lia:nts:|lj:@:	1
pire	p:i:re|p:i:R	1
carmes	c:a:rmes|k:a:Rm	1
kif	k:i:f|k:i:f	1
paf	p:a:f|p:a:f	1
lap	l:a:p|l:a:p	1
glus	gl:us:|gl:y:	1
roms	r:o:ms|R:O:m	1
albe	:a:lbe|:a:lb	1
râles	r:â:les|R:a:l	1
zones	z:o:nes|z:o:n	1
boxe	b:o:xe|b:O:ks	1
cidre	c:i:dre|s:i:dR	1
niable	ni:a:ble|nj:a:bl	1
roi	ro:i:|Rw:a:	1
cymes	c:y:mes|s:i:m	1
manges	m:an:ges|m:@:Z	1
chocs	ch:o:cs|S:O:k	1
cambres	c:a:mbres|k:@:bR	1
litre	l:i:tre|l:i:tR	1
khâgnes	kh:â:gnes|k:a:N	1
prêtes	pr:ê:tes|pR:E:t	1
non	n:on:|n:§:	1
mur	m:u:r|m:y:R	1
chairs	ch:ai:rs|S:E:R	1
drille	dr:i:lle|dR:i:j	1
frusques	fr:u:sques|fR:y:sk	1
nèpe	n:è:pe|n:E:p	1
mandes	m:an:des|m:@:d	1
veille	v:e:ille|v:E:j	1
iles	:i:les|:i:l	1
leur	l:eu:r|l:9:R	1
chèche	ch:è:che|S:E:S	1
aptes	:a:ptes|:a:pt	1
lignes	l:i:gnes|l:i:N	1
brindes	br:in:des|bR:5:d	1
touts	t:outs:|t:u:	1
sais	s:ais:|s:E:	1
nient	n:ient:|n:i:	1
chaume	ch:au:me|S:o:m	1
socs	s:o:cs|s:O:k	1
douer	dou:er:|dw:e:	1
ceindre	ce:in:dre|s:5:dR	1
fasses	f:a:sses|f:a:s	1
blob	bl:o:b|bl:O:b	1
geai	ge:ai:|Z:E:	1
sa	s:a:|s:a:	1
squaws	squa:ws:|skw:o:	1
rondes	r:on:des|R:§:d	1
veaux	ve:aux:|v:o:	1
faibles	f:ai:bles|f:E:bl	1
argue	:a:rgue|:a:Rg	1
nouent	n:ouent:|n:u:	1
cotent	c:o:tent|k:O:t	1
mol	m:o:l|m:O:l	1
grue	gr:ue:|gR:y:	1
franques	fr:an:ques|fR:@:k	1
choses	ch:o:ses|S:o:z	1
grène	gr:è:ne|gR:E:n	1
bouf	b:ou:f|b:u:f	1
neuf	n:eu:f|n:9:f	1
chiens	chie:ns:|Sj:5:	1
drope	dr:o:pe|dR:O:p	1
piaille	pi:a:ille|pj:a:j	1
grouses	gr:ou:ses|gR:u:z	1
moûts	mo:ûts:|m:u:	1
rouant	rou:ant:|Rw:@:	1
cent	ce:nt:|s:@:	1
trinque	tr:in:que|tR:5:k	1
goures	g:ou:res|g:u:R	1
craintes	cra:in:tes|kR:5:t	1
soupes	s:ou:pes|s:u:p	1
basque	b:a:sque|b:a:sk	1
pouffe	p:ou:ffe|p:u:f	1
lampes	l:am:pes|l:@:p	1
baies	b:aies:|b:E:	1
mort	m:or:t|m:O:R	1
hack	:ha:ck|:a:k	1
matchs	m:a:tchs|m:a:tS	1
cime	c:i:me|s:i:m	1
reître	r:e:ître|R:E:tR	1
droit	droi:t:|dRw:a:	1
sentes	s:en:tes|s:@:t	1
vautrent	v:au:trent|v:o:tR	1
claires	cl:ai:res|kl:E:R	1
trinques	tr:in:ques|tR:5:k	1
clignent	cl:i:gnent|kl:i:N	1
ruse	r:u:se|R:y:z	1
laird	l:ai:rd|l:E:R	1
spots	sp:o:ts|sp:O:t	1
cible	c:i:ble|s:i:bl	1
âtres	:â:tres|:a:tR	1
souffrent	s:ou:ffrent|s:u:fR	1
fend	f:end:|f:@:	1
pâment	p:â:ment|p:a:m	1
tournes	t:ou:rnes|t:u:Rn	1
mach	m:a:ch|m:a:k	1
hier	hi:e:r|j:E:R	1
barde	b:a:rde|b:a:Rd	1
beigne	b:e:igne|b:E:N	1
chiotte	chi:ot:te|Sj:O:t	1
mols	m:o:ls|m:O:l	1
rîmes	r:î:mes|R:i:m	1
sites	s:i:tes|s:i:t	1
buttes	b:ut:tes|b:y:t	1
apes	:a:pes|:a:p	1
chape	ch:a:pe|S:a:p	1
moine	mo:i:ne|mw:a:n	1
gens	ge:ns:|Z:@:	1
gouines	gou:i:nes|gw:i:n	1
uses	:u:ses|:y:z	1
col	c:o:l|k:O:l	1
berle	b:e:rle|b:E:Rl	1
cils	c:i:ls|s:i:l	1
zouaves	zou:a:ves|zw:a:v	1
chic	ch:i:c|S:i:k	1
mousses	m:ou:sses|m:u:s	1
to	t:o:|t:o:	1
raz	ra:z:|R:a:	1
suave	su:a:ve|s8:a:v	1
poudre	p:ou:dre|p:u:dR	1
cré	cr:é:|kR:e:	1
houles	:hou:les|:u:l	1
dig	d:i:g|d:i:g	1
drains	dr:ains:|dR:5:	1
crashes	cr:as:hes|kR:a:S	1
prives	pr:i:ves|pR:i:v	1
clefs	cl:efs:|kl:e:	1
fieux	fie:ux:|fj:2:	1
crible	cr:i:ble|kR:i:bl	1
grippe	gr:i:ppe|gR:i:p	1
craps	cr:a:ps|kR:a:p	1
min	m:i:n|m:i:n	1
gobes	g:o:bes|g:O:b	1
riche	r:i:che|R:i:S	1
flan	fl:an:|fl:@:	1
gazes	g:a:zes|g:a:z	1
nouilles	n:ou:illes|n:u:j	1
quiche	qu:i:che|k:i:S	1
file	f:i:le|f:i:l	1
lisses	l:i:sses|l:i:s	1
plaie	pl:aie:|pl:E:	1
targue	t:a:rgue|t:a:Rg	1
grêles	gr:ê:les|gR:E:l	1
bruges	br:u:ges|bR:y:Z	1
alpe	:a:lpe|:a:lp	1
gay	g:ay:|g:E:	1
selle	s:el:le|s:E:l	1
rial	ri:a:l|Rj:a:l	1
prêches	pr:ê:ches|pR:E:S	1
contes	c:on:tes|k:§:t	1
burne	b:u:rne|b:y:Rn	1
notent	n:o:tent|n:O:t	1
breuil	br:eu:il|bR:9:j	1
feux	f:eux:|f:2:	1
grondent	gr:on:dent|gR:§:d	1
fument	f:u:ment|f:y:m	1
glands	gla:nds:|gl:@:	1
scanne	sc:a:nne|sk:a:n	1
ès	:è:s|:E:s	1
pole	p:o:le|p:O:l	1
lèvre	l:è:vre|l:E:vR	1
schlass	schl:a:ss|Sl:a:s	1
marle	m:a:rle|m:a:Rl	1
lièvre	li:è:vre|lj:E:vR	1
cingle	c:in:gle|s:5:gl	1
clip	cl:i:p|kl:i:p	1
ris	r:is:|R:i:	1
vive	v:i:ve|v:i:v	1
tzars	tz:a:rs|ts:a:R	1
pioche	pi:o:che|pj:O:S	1
mettes	m:et:tes|m:E:t	1
erg	:e:rg|:E:Rg	1
peint	p:eint:|p:5:	1
paix	p:aix:|p:E:	1
têt	t:êt:|t:E:	1
glaives	gl:ai:ves|gl:E:v	1
flache	fl:a:che|fl:a:S	1
cep	c:e:p|s:E:p	1
mangue	m:an:gue|m:@:g	1
fiais	fi:ais:|fj:E:	1
rêche	r:ê:che|R:E:S	1
grappe	gr:a:ppe|gR:a:p	1
fresques	fr:e:sques|fR:E:sk	1
baille	b:a:ille|b:a:j	1
poivrent	po:i:vrent|pw:a:vR	1
clause	cl:au:se|kl:o:z	1
gnards	gn:a:rds|N:a:R	1
pars	p:a:rs|p:a:R	1
rail	r:a:il|R:a:j	1
loute	l:ou:te|l:u:t	1
kick	k:i:ck|k:i:k	1
sue	s:ue:|s:y:	1
viens	vie:ns:|vj:5:	1
fifres	f:i:fres|f:i:fR	1
crois	croi:s:|kRw:a:	1
guelfe	gu:e:lfe|g:E:lf	1
pian	pi:an:|pj:@:	1
taon	t:aon:|t:@:	1
sis	s:is:|s:i:	1
aphtes	:a:phtes|:a:ft	1
tuf	t:u:f|t:y:f	1
fieu	fie:u:|fj:2:	1
zou	z:ou:|z:u:	1
frire	fr:i:re|fR:i:R	1
ratent	r:a:tent|R:a:t	1
manque	m:an:que|m:@:k	1
meure	m:eu:re|m:9:R	1
celles	c:el:les|s:E:l	1
calce	c:a:lce|k:a:ls	1
drisses	dr:i:sses|dR:i:s	1
chyle	ch:y:le|S:i:l	1
chaise	ch:ai:se|S:E:z	1
lâches	l:â:ches|l:a:S	1
vissent	v:i:ssent|v:i:s	1
moites	mo:i:tes|mw:a:t	1
rages	r:a:ges|R:a:Z	1
patchs	p:a:tchs|p:a:tS	1
nages	n:a:ges|n:a:Z	1
franches	fr:an:ches|fR:@:S	1
mêmes	m:ê:mes|m:E:m	1
nem	n:e:m|n:E:m	1
droguent	dr:o:guent|dR:O:g	1
bouchent	b:ou:chent|b:u:S	1
tirs	t:i:rs|t:i:R	1
coudre	c:ou:dre|k:u:dR	1
teams	t:e:ams|t:i:m	1
nases	n:a:ses|n:a:z	1
soir	so:i:r|sw:a:R	1
ding	d:i:ng|d:i:G	1
lustre	l:u:stre|l:y:stR	1
fiassent	fi:a:ssent|fj:a:s	1
tons	t:ons:|t:§:	1
flous	fl:ous:|fl:u:	1
pointent	po:in:tent|pw:5:t	1
puent	p:uent:|p:y:	1
fié	fi:é:|fj:e:	1
gaules	g:au:les|g:o:l	1
rouent	r:ouent:|R:u:	1
brames	br:a:mes|bR:a:m	1
ceints	ce:ints:|s:5:	1
fondent	f:on:dent|f:§:d	1
langue	l:an:gue|l:@:g	1
laies	l:aies:|l:E:	1
geôle	ge:ô:le|Z:o:l	1
ranche	r:an:che|R:@:S	1
pain	p:ain:|p:5:	1
came	c:a:me|k:a:m	1
schtroumf	schtr:ou:mf|StR:u:mf	1
nattes	na:t:tes|n:a:t	1
loir	lo:i:r|lw:a:R	1
vide	v:i:de|v:i:d	1
brilles	br:i:lles|bR:i:j	1
stagne	st:a:gne|st:a:gn	1
fia	fi:a:|fj:a:	1
hure	:hu:re|:y:R	1
ouche	:ou:che|:u:S	1
siffles	s:i:ffles|s:i:fl	1
sioux	si:oux:|sj:u:	1
bats	b:ats:|b:a:	1
biefs	bi:e:fs|bj:E:f	1
guilde	gu:i:lde|g:i:ld	1
drape	dr:a:pe|dR:a:p	1
fille	f:i:lle|f:i:j	1
algue	:a:lgue|:a:lg	1
sculptes	sc:u:lptes|sk:y:lt	1
fouge	f:ou:ge|f:u:Z	1
pûmes	p:û:mes|p:y:m	1
feurre	f:eur:re|f:9:R	1
strip	str:i:p|stR:i:p	1
viol	vi:o:l|vj:O:l	1
bravent	br:a:vent|bR:a:v	1
onze	:onz:e|:§:z	1
fable	f:a:ble|f:a:bl	1
arts	:art:s|:a:R	1
fraîches	fr:aî:ches|fR:E:S	1
encre	:en:cre|:@:kR	1
transe	tr:an:se|tR:@:s	1
puddle	p:u:ddle|p:9:dl	1
glissent	gl:i:ssent|gl:i:s	1
guiches	gu:i:ches|g:i:S	1
as	:a:s|:a:s	1
rouvre	r:ou:vre|R:u:vR	1
rabs	r:a:bs|R:a:b	1
fendre	f:en:dre|f:@:dR	1
pape	p:a:pe|p:a:p	1
gypses	g:y:pses|Z:i:ps	1
touque	t:ou:que|t:u:k	1
ord	:o:rd|:O:R	1
hombre	:ho:mbre|:§:bR	1
hurle	:hu:rle|:y:Rl	1
mûr	m:û:r|m:y:R	1
rads	r:a:ds|R:a:d	1
prêche	pr:ê:che|pR:E:S	1
moite	mo:i:te|mw:a:t	1
scout	sc:ou:t|sk:u:t	1
zig	z:i:g|z:i:g	1
bouclent	b:ou:clent|b:u:kl	1
raves	r:a:ves|R:a:v	1
lord	l:o:rd|l:O:R	1
plaides	pl:ai:des|pl:E:d	1
gun	g:u:n|g:9:n	1
gel	g:e:l|Z:E:l	1
draps	dr:aps:|dR:a:	1
bisse	b:i:sse|b:i:s	1
rive	r:i:ve|R:i:v	1
sciène	sci:è:ne|sj:E:n	1
skin	sk:i:n|sk:i:n	1
outre	:ou:tre|:u:tR	1
herbe	:he:rbe|:E:Rb	1
gents	ge:nts:|Z:@:	1
tels	t:e:ls|t:E:l	1
cule	c:u:le|k:y:l	1
chien	chie:n:|Sj:5:	1
vannent	v:a:nnent|v:a:n	1
porte	p:o:rte|p:O:Rt	1
rênes	r:ê:nes|R:E:n	1
toile	to:i:le|tw:a:l	1
tell	t:e:ll|t:E:l	1
fouets	fou:ets:|fw:E:	1
gonfle	g:on:fle|g:§:fl	1
disque	d:i:sque|d:i:sk	1
minent	m:i:nent|m:i:n	1
vape	v:a:pe|v:a:p	1
uns	:uns:|:1:	1
plique	pl:i:que|pl:i:k	1
coules	c:ou:les|k:u:l	1
blouses	bl:ou:ses|bl:u:z	1
maux	m:aux:|m:o:	1
bugles	b:u:gles|b:y:gl	1
cligne	cl:i:gne|kl:i:N	1
restent	r:e:stent|R:E:st	1
poules	p:ou:les|p:u:l	1
vrillent	vr:i:llent|vR:i:j	1
gon	g:o:n|g:o:n	1
drave	dr:a:ve|dR:a:v	1
quarks	qu:a:rks|kw:a:Rk	1
mua	mu:a:|m8:a:	1
van	v:a:n|v:a:n	1
lieue	lie:ue:|lj:2:	1
orge	:o:rge|:O:RZ	1
laid	l:aid:|l:E:	1
saie	s:aie:|s:E:	1
pionces	pi:on:ces|pj:§:s	1
siéent	si:éent:|sj:e:	1
pillent	p:i:llent|p:i:j	1
chip	ch:i:p|S:i:p	1
chiot	chi:ot:|Sj:o:	1
tigres	t:i:gres|t:i:gR	1
pink	p:in:k|p:5:k	1
esche	:es:che|:E:S	1
tente	t:en:te|t:@:t	1
noueuses	nou:eu:ses|nw:2:z	1
bougres	b:ou:gres|b:u:gR	1
flegme	fl:e:gme|fl:E:gm	1
oies	o:ies:|w:a:	1
zigue	z:i:gue|z:i:g	1
flood	flo:o:d|fl:u:d	1
bosse	b:o:sse|b:O:s	1
bâilles	b:â:illes|b:a:j	1
louer	lou:er:|lw:e:	1
luce	l:u:ce|l:y:s	1
lises	l:i:ses|l:i:z	1
seras	ser:as:|sR:a:	1
croûtes	cr:oû:tes|kR:u:t	1
pave	p:a:ve|p:a:v	1
cliques	cl:i:ques|kl:i:k	1
flambent	fla:m:bent|fl:@:b	1
bits	b:i:ts|b:i:t	1
crispe	cr:i:spe|kR:i:sp	1
tin	t:in:|t:5:	1
belles	b:el:les|b:E:l	1
serge	s:e:rge|s:E:RZ	1
purent	p:u:rent|p:y:R	1
règles	r:è:gles|R:E:gl	1
odes	:o:des|:O:d	1
frênes	fr:ê:nes|fR:E:n	1
lue	l:ue:|l:y:	1
vieille	vi:e:ille|vj:E:j	1
fafs	f:a:fs|f:a:f	1
tipe	t:i:pe|t:i:p	1
mangues	m:an:gues|m:@:g	1
miaule	mi:au:le|mj:o:l	1
ouf	:ou:f|:u:f	1
seigles	s:e:igles|s:E:gl	1
houlque	:hou:lque|:u:lk	1
flingue	fl:in:gue|fl:5:g	1
bées	b:ées:|b:e:	1
neutre	n:eu:tre|n:2:tR	1
deals	d:e:als|d:i:l	1
hère	:hè:re|:E:R	1
renne	r:en:ne|R:E:n	1
ladre	l:a:dre|l:a:dR	1
dur	d:u:r|d:y:R	1
tafs	t:a:fs|t:a:f	1
skieuses	skie:u:ses|skj:2:z	1
feutres	f:eu:tres|f:2:tR	1
hausses	:hau:sses|:o:s	1
saquent	s:a:quent|s:a:k	1
fans	f:a:ns|f:a:n	1
braille	br:a:ille|bR:a:j	1
tube	t:u:be|t:y:b	1
lents	l:ents:|l:@:	1
veillent	v:e:illent|v:E:j	1
loi	lo:i:|lw:a:	1
force	f:o:rce|f:O:Rs	1
louanges	lou:an:ges|lw:@:Z	1
âpre	:â:pre|:a:pR	1
fâche	f:â:che|f:a:S	1
ders	d:e:rs|d:E:R	1
dièdre	di:è:dre|dj:E:dR	1
yaks	y:a:ks|j:a:k	1
claies	cl:aies:|kl:E:	1
tuait	tu:ait:|t8:E:	1
caves	c:a:ves|k:a:v	1
nuas	nu:as:|n8:a:	1
verts	v:e:rts|v:E:R	1
fauchent	f:au:chent|f:o:S	1
