a	:a:|:aː:	91
aagje	:aa:g:j:e:|:aː:ç:j:ə:	3
aai	:aa:i|:aː:j	18
aaien	:aa:i::e:n|:aː::j:ə:	5
aait	:aa:it|:aː:jt	34
aan	:aa:n|:aː:n	2336
aandacht	:aa:n:d:a:cht|:aː:n:d:ɑ:çt	3
aandachtig	:aa:n:d:a:ch:t:i:g|:aː:n:d:ɑ:ç:t:ə:ç	2
aandoen	:aa:n:d:oe:n|:aː:n:d:uː:n	4
aangekleed	:aa:n:g:e::kl:ee:d|:aː:ŋ:ɣ:ə::kl:eː:t	4
aangerend	:aa:n:g:e::r:e:nd|:aː:ŋ:ɣ:ə::r:ɛ:nt	3
aangeven	:aa:n:g:e::v:e:n|:aː:ŋ:ɣ:eː::v:ə:	4
aankijken	:aa:n:k:ij::k:e:n|:aː:ŋ:k:ɛi::k:ə:	3
aankijkt	:aa:n:k:ij:kt|:aː:ŋ:k:ɛi:kt	2
aankleden	:aa:n:kl:e::d:e:n|:aː:ŋ:kl:eː::d:ə:	5
aankomen	:aa:n:k:o::m:e:n|:aː:ŋ:k:oː::m:ə:	4
aanloop	:aa:n:l:oo:p|:aː:n:l:oː:p	3
aanlopen	:aa:n:l:o::p:e:n|:aː:n:l:oː::p:ə:	2
aanraakt	:aa:n:r:aa:kt|:aː:n:r:aː:kt	2
aanraken	:aa:n:r:a::k:e:n|:aː:n:r:aː::k:ə:	2
aanrecht	:aa:n:r:e:cht|:aː:n:r:ɛ:çt	6
aantrek	:aa:n:tr:e:k|:aː:n:tr:ɛ:k	2
aantrekken	:aa:n:tr:e:k:k:e:n|:aː:n:tr:ɛ::k:ə:	4
aantrekt	:aa:n:tr:e:kt|:aː:n:tr:ɛ:kt	2
aanvallen	:aa:n:v:a:l:l:e:n|:aː:n:v:ɑ::l:ə:	4
aanvankelijk	:aa:n:v:a:n:k:e::l:ij:k|:aː:n:v:ɑ:ŋ:k:ə::l:ə:k	4
aanvliegen	:aa:n:vl:ie::g:e:n|:aː:n:vl:iː::ɣ:ə:	2
aanzetten	:aa:n:z:e:t:t:e:n|:aː:n:z:ɛ::t:ə:	2
aap	:aa:p|:aː:p	410
aapje	:aa:p:j:e:|:aː:p:j:ə:	52
aapjes	:aa:p:j:e:s|:aː:p:j:ə:s	2
aar	:aa:r|:aː:r	13
aardbeien	:aa:rd:b:ei:::e:n|:aː:rd:b:ɛi::j:ə:	6
aardbol	:aa:rd:b:o:l|:aː:rd:b:ɔ:l	4
aarde	:aa:r:d:e:|:aː:r:d:ə:	34
aardig	:aa:r:d:i:g|:aː:r:d:ə:ç	39
aart	:aa:rt|:aː:rt	62
aarzelen	:aa:r:z:e::l:e:n|:aː:r:z:ə::l:ə:	2
aarzelt	:aa:r:z:e:lt|:aː:r:z:ə:lt	6
aas	:aa:s|:aː:s	33
absoluut	:a:b:s:o::l:uu:t|:ɑ:p:s:oː::l:yː:t	2
ach	:a:ch|:ɑ:ç	35
acht	:a:cht|:ɑ:çt	61
achtbaan	:a:cht:b:aa:n|:ɑ:ɣd:b:aː:n	5
achter	:a:ch:t:e:r|:ɑ:ç:t:ə:r	232
achteraan	:a:ch:t:e:r::aa:n|:ɑ:ç:t:ə:r::aː:n	5
achteren	:a:ch:t:e::r:e:n|:ɑ:ç:t:ə::r:ə:	3
achterin	:a:ch:t:e:r::i:n|:ɑ:ç:t:ə:r::ɪ:n	5
achterkant	:a:ch:t:e:r:k:a:nt|:ɑ:ç:t:ə:r:k:ɑ:nt	11
achterna	:a:ch:t:e:r:n:a:|:ɑ:ç:t:ə:r:n:aː:	6
achterom	:a:ch:t:e:r::o:m|:ɑ:ç:t:ə:r::ɔ:m	4
achterop	:a:ch:t:e:r::o:p|:ɑ:ç:t:ə:r::ɔ:p	10
achterover	:a:ch:t:e:r::o::v:e:r|:ɑ:ç:t:ə:r::oː::v:ə:r	4
achteruit	:a:ch:t:e:r::ui:t|:ɑ:ç:t:ə:r::œy:t	19
achttien	:a:cht:t:ie:n|:ɑ:ç:t:iː:n	5
acrobaten	:a::cr:o::b:a::t:e:n|:ɑ::kr:oː::b:aː::t:ə:	3
adem	:a::d:e:m|:aː::d:ə:m	31
ademt	:a::d:e:mt|:aː::d:ə:mt	2
adres	:a::dr:e:s|:ɑ::dr:ɛ:s	5
af	:a:f|:ɑ:f	424
afdak	:a:f:d:a:k|:ɑ:v:d:ɑ:k	2
afdrogen	:a:f:dr:o::g:e:n|:ɑ:v:dr:oː::ɣ:ə:	2
afdrukken	:a:f:dr:u:k:k:e:n|:ɑ:v:dr:ʉ::k:ə:	3
afgelopen	:a:f:g:e::l:o::p:e:n|:ɑ:f:ç:ə::l:oː::p:ə:	5
afgesproken	:a:f:g:e::spr:o::k:e:n|:ɑ:f:ç:ə::spr:oː::k:ə:	4
afgrond	:a:f:gr:o:nd|:ɑ:f:çr:ɔ:nt	7
afloop	:a:f:l:oo:p|:ɑ:f:l:oː:p	9
afloopt	:a:f:l:oo:pt|:ɑ:f:l:oː:pt	9
aflopen	:a:f:l:o::p:e:n|:ɑ:f:l:oː::p:ə:	2
afnemen	:a:f:n:e::m:e:n|:ɑ:f:n:eː::m:ə:	5
afronding	:a:f:r:o:n:d:i:ng|:ɑ:f:r:ɔ:n:d:ɪ:ŋ	23
afscheid	:a:f:sch:ei:d|:ɑ:f:sç:ɛi:t	5
afslag	:a:f:sl:a:g|:ɑ:f:sl:ɑ:ç	6
afspraak	:a:f:spr:aa:k|:ɑ:f:spr:aː:k	2
afstand	:a:f:st:a:nd|:ɑ:f:st:ɑ:nt	2
afval	:a:f:v:a:l|:ɑ::f:ɑ:l	4
afvallen	:a:f:v:a:l:l:e:n|:ɑ::f:ɑ::l:ə:	3
afwas	:a:f:w:a:s|:ɑ:f:w:ɑ:s	7
afwasbak	:a:f:w:a:s:b:a:k|:ɑ:f:w:ɑ:z:b:ɑ:k	2
afzetten	:a:f:z:e:t:t:e:n|:ɑ:f:s:ɛ::t:ə:	3
agent	:a::g:e:nt|:aː::ɣ:ɛ:nt	22
ah	:a:h|:aː:	6
aha	:a::h:a:|:aː::h:aː:	6
akelig	:a::k:e::l:i:g|:aː::k:ə::l:ə:ç	5
al	:a:l|:ɑ:l	918
album	:a:l:b:u:m|:ɑ:l:b:ʉ:m	3
allang	:a:l:l:a:ng|:ɑ::l:ɑ:ŋ	10
alle	:a:l:l:e:|:ɑ::l:ə:	248
allebei	:a:l:l:e::b:ei:|:ɑ::l:ə::b:ɛi:	36
alleen	:a:l:l:ee:n|:ɑ::l:eː:n	308
allemaal	:a:l:l:e::m:aa:l|:ɑ::l:ə::m:aː:l	113
allerlei	:a:l:l:e:r:l:ei:|:ɑ::l:ə:r:l:ɛi:	8
alles	:a:l:l:e:s|:ɑ::l:ə:s	395
almaar	:a:l:m:aa:r|:ɑ:l:m:aː:r	5
als	:a:ls|:ɑ:ls	1154
alsjeblieft	:a:ls:j:e::bl:ie:ft|:ɑ:ls:j:ə::bl:iː:ft	10
alsof	:a:ls::o:f|:ɑ:ls::ɔ:f	52
alstublieft	:a:ls:t:u::bl:ie:ft|:ɑ:ls:t:yː::bl:iː:ft	2
altijd	:a:l:t:ij:d|:ɑ:l:t:ɛi:t	203
alvast	:a:l:v:a:st|:ɑ:l:v:ɑ:st	7
alweer	:a:l:w:ee:r|:ɑ:l:w:eː:r	30
amper	:a:m:p:e:r|:ɑ:m:p:ə:r	2
ananas	:a::n:a::n:a:s|:aː::n:aː::n:ɑ:s	5
ander	:a:n:d:e:r|:ɑ:n:d:ə:r	82
andere	:a:n:d:e::r:e:|:ɑ:n:d:ə::r:ə:	193
anders	:a:n:d:e:rs|:ɑ:n:d:ə:rs	212
andersom	:a:n:d:e:rs::o:m|:ɑ:n:d:ə:rs::ɔ:m	5
angst	:a:ngst|:ɑ:ŋst	7
angstig	:a:ng:st:i:g|:ɑ:ŋ:st:ə:ç	7
anker	:a:n:k:e:r|:ɑ:ŋ:k:ə:r	12
antwoord	:a:nt:w:oo:rd|:ɑ:nt:w:oː:rt	43
antwoorden	:a:nt:w:oo:r:d:e:n|:ɑ:nt:w:oː:r:d:ə:	3
antwoordt	:a:nt:w:oo:rdt|:ɑ:nt:w:oː:rt	33
apart	:a::p:a:rt|:aː::p:ɑ:rt	5
aparte	:a::p:a:r:t:e:|:aː::p:ɑ:r:t:ə:	3
apen	:a::p:e:n|:aː::p:ə:	25
apparaat	:a:p:p:a::r:aa:t|:ɑ::p:aː::r:aː:t	3
appel	:a:p:p:e:l|:ɑ::p:ə:l	15
appel	:a:p:p:e:l|:ɑ::p:ɛ:l	15
appelboom	:a:p:p:e:l:b:oo:m|:ɑ::p:ə:l:b:oː:m	2
appelmoes	:a:p:p:e:l:m:oe:s|:ɑ::p:ə:l:m:uː:s	10
appels	:a:p:p:e:ls|:ɑ::p:ə:ls	10
appels	:a:p:p:e:ls|:ɑ::p:ɛ:ls	10
appelsap	:a:p:p:e:l:s:a:p|:ɑ::p:ə:l:s:ɑ:p	3
appeltaart	:a:p:p:e:l:t:aa:rt|:ɑ::p:ə:l:t:aː:rt	8
appeltje	:a:p:p:e:l:tj:e:|:ɑ::p:ə:l:tj:ə:	5
applaus	:a:p:pl:au:s|:ɑ::pl:ɑu:s	16
arm	:a:rm|:ɑ:rm	83
armband	:a:rm:b:a:nd|:ɑ:rm:b:ɑ:nt	11
arme	:a:r:m:e:|:ɑ:r:m:ə:	25
armen	:a:r:m:e:n|:ɑ:r:m:ə:	44
artiesten	:a:r:t:ie:s:t:e:n|:ɑ:r:t:iː:s:t:ə:	3
arts	:a:rts|:ɑ:rts	10
as	:a:s|:ɑ:s	3
asbak	:a:s:b:a:k|:ɑ:z:b:ɑ:k	4
astronaut	:a:s:tr:o::n:au:t|:ɑ:s:tr:oː::n:ɑu:t	2
at	:a:t|:ɑ:t	23
aten	:a::t:e:n|:aː::t:ə:	4
atlas	:a:t:l:a:s|:ɑ:t:l:ɑ:s	3
au	:au:|:ɑu:	120
auteur	:au::t:eu:r|:ɑu::t:øː:r	16
auteurs	:au::t:eu:rs|:ɑu::t:øː:rs	5
auto	:au::t:o:|:ɑu::t:oː:	149
autootjes	:au::t:o::tj:e:s|:ɑu::t:oː::tj:ə:s	3
autorijden	:au::t:o::r:ij::d:e:n|:ɑu::t:oː::r:ɛi::d:ə:	2
avond	:a::v:o:nd|:aː::v:ɔ:nt	34
avonds	:a::v:o:nds|:aː::v:ɔ:nts	4
avonturen	:a::v:o:n:t:u::r:e:n|:aː::v:ɔ:n:t:yː::r:ə:	3
avontuur	:a::v:o:n:t:uu:r|:aː::v:ɔ:n:t:yː:r	28
azijn	:a::z:ij:n|:aː::z:ɛi:n	3
b	b::|b:eː:	211
ba	b:a:|b:aː:	15
ba	b:a:|b:ɑ:	15
baai	b:aa:i|b:aː:j	14
baak	b:aa:k|b:aː:k	3
baal	b:aa:l|b:aː:l	4
baalt	b:aa:lt|b:aː:lt	4
baan	b:aa:n|b:aː:n	46
baantje	b:aa:n:tj:e:|b:aː:n:tj:ə:	2
baantjes	b:aa:n:tj:e:s|b:aː:n:tj:ə:s	5
baard	b:aa:rd|b:aː:rt	45
baas	b:aa:s|b:aː:s	266
baasje	b:aa:s:j:e:|b:aː:s:j:ə:	12
baby	b:a::b:y:|b:eː::b:iː:	24
bad	b:a:d|b:ɑ:t	119
badje	b:a:d:j:e:|b:ɑ:t:j:ə:	7
badkamer	b:a:d:k:a::m:e:r|b:ɑ:t:k:aː::m:ə:r	10
badkuip	b:a:d:k:ui:p|b:ɑ:t:k:œy:p	6
badpak	b:a:d:p:a:k|b:ɑ:t:p:ɑ:k	10
bagage	b:a::g:a::g:e:|b:ɑ::ɣ:aː::ʒ:ə:	4
bah	b:a:h|b:aː:	31
bah	b:a:h|b:ɑ:	31
bak	b:a:k|b:ɑ:k	152
bakje	b:a:k:j:e:|b:ɑ:k:j:ə:	7
bakjes	b:a:k:j:e:s|b:ɑ:k:j:ə:s	2
bakken	b:a:k:k:e:n|b:ɑ::k:ə:	35
bakker	b:a:k:k:e:r|b:ɑ::k:ə:r	69
bakt	b:a:kt|b:ɑ:kt	35
bakte	b:a:k:t:e:|b:ɑ:k:t:ə:	4
bal	b:a:l|b:ɑ:l	288
balk	b:a:lk|b:ɑ:lk	7
balken	b:a:l:k:e:n|b:ɑ:l:k:ə:	3
balkon	b:a:l:k:o:n|b:ɑ:l:k:ɔ:n	4
balkt	b:a:lkt|b:ɑ:lkt	4
ballen	b:a:l:l:e:n|b:ɑ::l:ə:	11
ballet	b:a:l:l:e:t|b:ɑ::l:ɛ:t	8
balletje	b:a:l:l:e::tj:e:|b:ɑ::l:ə::tj:ə:	3
balletjes	b:a:l:l:e::tj:e:s|b:ɑ::l:ə::tj:ə:s	7
ballon	b:a:l:l:o:n|b:ɑ::l:ɔ:n	58
balpen	b:a:l:p:e:n|b:ɑ:l:p:ɛ:n	8
balt	b:a:lt|b:ɑ:lt	3
bamboe	b:a:m:b:oe:|b:ɑ:m:b:uː:	2
banaan	b:a::n:aa:n|b:aː::n:aː:n	18
bananen	b:a::n:a::n:e:n|b:aː::n:aː::n:ə:	14
band	b:a:nd|b:ɑ:nt	35
band	b:a:nd|b:ɛ:nt	35
bang	b:a:ng|b:ɑ:ŋ	273
bange	b:a:n:g:e:|b:ɑ::ŋ:ə:	5
bank	b:a:nk|b:ɑ:ŋk	154
banken	b:a:n:k:e:n|b:ɑ:ŋ:k:ə:	3
bankje	b:a:nk:j:e:|b:ɑ:ŋk:j:ə:	20
bar	b:a:r|b:ɑ:r	3
barst	b:a:rst|b:ɑ:rst	17
bas	b:a:s|b:ɑ:s	285
bed	b:e:d|b:ɛ:t	343
bedacht	b:e::d:a:cht|b:ə::d:ɑ:çt	31
bedanken	b:e::d:a:n:k:e:n|b:ə::d:ɑ:ŋ:k:ə:	2
bedankt	b:e::d:a:nkt|b:ə::d:ɑ:ŋkt	26
bedden	b:e:d:d:e:n|b:ɛ::d:ə:	7
bedekt	b:e::d:e:kt|b:ə::d:ɛ:kt	4
bedenk	b:e::d:e:nk|b:ə::d:ɛ:ŋk	17
bedenken	b:e::d:e:n:k:e:n|b:ə::d:ɛ:ŋ:k:ə:	14
bedenkt	b:e::d:e:nkt|b:ə::d:ɛ:ŋkt	19
bedje	b:e:d:j:e:|b:ɛ:t:j:ə:	2
bedoel	b:e::d:oe:l|b:ə::d:uː:l	30
bedoeld	b:e::d:oe:ld|b:ə::d:uː:lt	2
bedoelen	b:e::d:oe::l:e:n|b:ə::d:uː::l:ə:	7
bedoeling	b:e::d:oe::l:i:ng|b:ə::d:uː::l:ɪ:ŋ	5
bedoelt	b:e::d:oe:lt|b:ə::d:uː:lt	11
bedrag	b:e::dr:a:g|b:ə::dr:ɑ:ç	3
bedroefd	b:e::dr:oe:fd|b:ə::dr:uː:ft	5
bedtijd	b:e:d:t:ij:d|b:ɛ::t:ɛi:t	6
beef	b:ee:f|b:eː:f	3
beeft	b:ee:ft|b:eː:ft	24
beek	b:ee:k|b:eː:k	86
beeld	b:ee:ld|b:eː:lt	22
beelden	b:ee:l:d:e:n|b:eː:l:d:ə:	14
beeldje	b:ee:ld:j:e:|b:eː:lt:j:ə:	9
been	b:ee:n|b:eː:n	164
beer	b:ee:r|b:eː:r	800
beertje	b:ee:r:tj:e:|b:eː:r:tj:ə:	29
beest	b:ee:st|b:eː:st	94
beesten	b:ee:s:t:e:n|b:eː:s:t:ə:	8
beestje	b:ee:st:j:e:|b:eː:st:j:ə:	14
beestjes	b:ee:st:j:e:s|b:eː:st:j:ə:s	21
beet	b:ee:t|b:eː:t	62
beetje	b:ee:t:j:e:|b:eː:t:j:ə:	218
begin	b:e::g:i:n|b:ə::ɣ:ɪ:n	34
beginnen	b:e::g:i:n:n:e:n|b:ə::ɣ:ɪ::n:ə:	43
begint	b:e::g:i:nt|b:ə::ɣ:ɪ:nt	138
begon	b:e::g:o:n|b:ə::ɣ:ɔ:n	22
begonnen	b:e::g:o:n:n:e:n|b:ə::ɣ:ɔ::n:ə:	5
begraven	b:e::gr:a::v:e:n|b:ə::ɣr:aː::v:ə:	6
begreep	b:e::gr:ee:p|b:ə::ɣr:eː:p	4
begrijp	b:e::gr:ij:p|b:ə::ɣr:ɛi:p	7
begrijpen	b:e::gr:ij::p:e:n|b:ə::ɣr:ɛi::p:ə:	3
begrijpt	b:e::gr:ij:pt|b:ə::ɣr:ɛi:pt	14
behalve	b:e::h:a:l:v:e:|b:ə::h:ɑ:l:v:ə:	5
behang	b:e::h:a:ng|b:ə::h:ɑ:ŋ	6
behoorlijk	b:e::h:oo:r:l:ij:k|b:ə::h:oː:r:l:ə:k	3
bek	b:e:k|b:ɛ:k	88
bekeek	b:e::k:ee:k|b:ə::k:eː:k	2
bekeken	b:e::k:e::k:e:n|b:ə::k:eː::k:ə:	3
bekend	b:e::k:e:nd|b:ə::k:ɛ:nt	9
beker	b:e::k:e:r|b:eː::k:ə:r	12
bekers	b:e::k:e:rs|b:eː::k:ə:rs	7
bekijk	b:e::k:ij:k|b:ə::k:ɛi:k	11
bekijken	b:e::k:ij::k:e:n|b:ə::k:ɛi::k:ə:	15
bekijkt	b:e::k:ij:kt|b:ə::k:ɛi:kt	24
bekken	b:e:k:k:e:n|b:ɛ::k:ə:	7
bel	b:e:l|b:ɛ:l	110
belangrijk	b:e::l:a:ng:r:ij:k|b:ə::l:ɑ:ŋ:r:ɛi:k	5
belangrijkste	b:e::l:a:ng:r:ij:k:st:e:|b:ə::l:ɑ:ŋ:r:ɛi:k:st:ə:	2
belden	b:e:l:d:e:n|b:ɛ:l:d:ə:	2
beleefd	b:e::l:ee:fd|b:ə::l:eː:ft	7
beleven	b:e::l:e::v:e:n|b:ə::l:eː::v:ə:	11
bellen	b:e:l:l:e:n|b:ɛ::l:ə:	26
belletje	b:e:l:l:e::tj:e:|b:ɛ::l:ə::tj:ə:	10
beloof	b:e::l:oo:f|b:ə::l:oː:f	12
beloofd	b:e::l:oo:fd|b:ə::l:oː:ft	8
belooft	b:e::l:oo:ft|b:ə::l:oː:ft	4
beloven	b:e::l:o::v:e:n|b:ə::l:oː::v:ə:	6
belt	b:e:lt|b:ɛ:lt	53
bemoeit	b:e::m:oe:it|b:ə::m:uː:jt	2
ben	b:e:n|b:ɛ:n	1702
benauwd	b:e::n:au:wd|b:ə::n:ɑu:wt	5
bende	b:e:n:d:e:|b:ɛ:n:d:ə:	2
beneden	b:e::n:e::d:e:n|b:ə::n:eː::d:ə:	55
benen	b:e::n:e:n|b:eː::n:ə:	32
benieuwd	b:e::n:ie:uwd|b:ə::n:iː:wt	20
bent	b:e:nt|b:ɛ:nt	308
beren	b:e::r:e:n|b:eː::r:ə:	12
beren	b:e::r:e:n|b:ə::r:ɛ:n	12
berg	b:e:rg|b:ɛ:rç	99
bergen	b:e:r:g:e:n|b:ɛ:r:ɣ:ə:	19
bergt	b:e:rgt|b:ɛ:rçt	2
bericht	b:e::r:i:cht|b:ə::r:ɪ:çt	3
berk	b:e:rk|b:ɛ:rk	4
berm	b:e:rm|b:ɛ:rm	3
beroemd	b:e::r:oe:md|b:ə::r:uː:mt	17
beroemde	b:e::r:oe:m:d:e:|b:ə::r:uː:m:d:ə:	8
beroep	b:e::r:oe:p|b:ə::r:uː:p	4
bes	b:e:s|b:ɛ:s	92
beschermd	b:e::sch:e:rmd|b:ə::sç:ɛ:rmt	4
beschermen	b:e::sch:e:r:m:e:n|b:ə::sç:ɛ:r:m:ə:	3
beschuit	b:e::sch:ui:t|b:ə::sç:œy:t	12
beslag	b:e::sl:a:g|b:ə::sl:ɑ:ç	8
beslist	b:e::sl:i:st|b:ə::sl:ɪ:st	8
besluit	b:e::sl:ui:t|b:ə::sl:œy:t	7
bessen	b:e:s:s:e:n|b:ɛ::s:ə:	13
best	b:e:st|b:ɛ:st	173
bestaan	b:e::st:aa:n|b:ə::st:aː:n	10
bestaat	b:e::st:aa:t|b:ə::st:aː:t	38
beste	b:e:s:t:e:|b:ɛ:s:t:ə:	72
bestel	b:e::st:e:l|b:ə::st:ɛ:l	2
betaal	b:e::t:aa:l|b:ə::t:aː:l	10
betaalt	b:e::t:aa:lt|b:ə::t:aː:lt	6
betalen	b:e::t:a::l:e:n|b:ə::t:aː::l:ə:	17
betekent	b:e::t:e::k:e:nt|b:ə::t:eː::k:ə:nt	16
beter	b:e::t:e:r|b:eː::t:ə:r	62
beteuterd	b:e::t:eu::t:e:rd|b:ə::t:øː::t:ə:rt	2
beu	b:eu:|b:øː:	23
beuk	b:eu:k|b:øː:k	22
beukt	b:eu:kt|b:øː:kt	2
beurt	b:eu:rt|b:øː:rt	64
beurten	b:eu:r:t:e:n|b:øː:r:t:ə:	4
beven	b:e::v:e:n|b:eː::v:ə:	4
bever	b:e::v:e:r|b:eː::v:ə:r	2
bevrijd	b:e::vr:ij:d|b:ə::vr:ɛi:t	2
bevroren	b:e::vr:o::r:e:n|b:ə::vr:oː::r:ə:	10
bewaakt	b:e::w:aa:kt|b:ə::w:aː:kt	2
bewaar	b:e::w:aa:r|b:ə::w:aː:r	6
bewaard	b:e::w:aa:rd|b:ə::w:aː:rt	7
bewaart	b:e::w:aa:rt|b:ə::w:aː:rt	3
bewaren	b:e::w:a::r:e:n|b:ə::w:aː::r:ə:	6
beweegt	b:e::w:ee:gt|b:ə::w:eː:çt	19
bewegen	b:e::w:e::g:e:n|b:ə::w:eː::ɣ:ə:	11
bewonderend	b:e::w:o:n:d:e::r:e:nd|b:ə::w:ɔ:n:d:ə::r:ə:nt	2
bewoog	b:e::w:oo:g|b:ə::w:oː:ç	8
bezaaid	b:e::z:aa:id|b:ə::z:aː:jt	3
bezem	b:e::z:e:m|b:eː::z:ə:m	8
bezems	b:e::z:e:ms|b:eː::z:ə:ms	6
bezet	b:e::z:e:t|b:ə::z:ɛ:t	2
bezig	b:e::z:i:g|b:eː::z:ə:ç	14
bezoek	b:e::z:oe:k|b:ə::z:uː:k	65
bezoeken	b:e::z:oe::k:e:n|b:ə::z:uː::k:ə:	9
bezorgd	b:e::z:o:rgd|b:ə::z:ɔ:rçt	13
bibber	b:i:b:b:e:r|b:ɪ::b:ə:r	4
bibberde	b:i:b:b:e:r:d:e:|b:ɪ::b:ə:r:d:ə:	3
bibberen	b:i:b:b:e::r:e:n|b:ɪ::b:ə::r:ə:	4
bibbert	b:i:b:b:e:rt|b:ɪ::b:ə:rt	12
bibliotheek	b:i::bl:i:::o::th:ee:k|b:iː::bl:iː::j:oː::t:eː:k	5
bid	b:i:d|b:ɪ:t	2
bieb	b:ie:b|b:iː:p	51
bier	b:ie:r|b:iː:r	14
bies	b:ie:s|b:iː:s	4
biet	b:ie:t|b:iː:t	36
big	b:i:g|b:ɪ:ç	109
biggen	b:i:g:g:e:n|b:ɪ::ɣ:ə:	2
bij	b:ij:|b:ɛi:	1657
bijen	b:ij:::e:n|b:ɛi::j:ə:	17
bijhouden	b:ij::h:ou::d:e:n|b:ɛi::h:ɑu::d:ə:	5
bijl	b:ij:l|b:ɛi:l	69
bijna	b:ij::n:a:|b:ɛi::n:aː:	176
bijt	b:ij:t|b:ɛi:t	81
bijten	b:ij::t:e:n|b:ɛi::t:ə:	13
bijtjes	b:ij::tj:e:s|b:ɛi::tj:ə:s	2
bijvoorbeeld	b:ij::v:oo:r:b:ee:ld|b:ɛi::v:oː:r:b:eː:lt	12
bijzonder	b:ij::z:o:n:d:e:r|b:iː::z:ɔ:n:d:ə:r	10
bijzondere	b:ij::z:o:n:d:e::r:e:|b:iː::z:ɔ:n:d:ə::r:ə:	6
bikkels	b:i:k:k:e:ls|b:ɪ::k:ə:ls	11
bil	b:i:l|b:ɪ:l	692
billen	b:i:l:l:e:n|b:ɪ::l:ə:	34
bind	b:i:nd|b:ɪ:nt	3
binden	b:i:n:d:e:n|b:ɪ:n:d:ə:	3
bindt	b:i:ndt|b:ɪ:nt	5
bink	b:i:nk|b:ɪ:ŋk	8
binnen	b:i:n:n:e:n|b:ɪ::n:ə:	200
binnenkant	b:i:n:n:e:n:k:a:nt|b:ɪ::n:ə::k:ɑ:nt	6
binnenkomen	b:i:n:n:e:n:k:o::m:e:n|b:ɪ::n:ə::k:oː::m:ə:	2
binnenkomt	b:i:n:n:e:n:k:o:mt|b:ɪ::n:ə::k:ɔ:mt	5
bitter	b:i:t:t:e:r|b:ɪ::t:ə:r	2
blaadje	bl:aa:d:j:e:|bl:aː:t:j:ə:	5
blaadjes	bl:aa:d:j:e:s|bl:aː:t:j:ə:s	8
blaar	bl:aa:r|bl:aː:r	2
blaas	bl:aa:s|bl:aː:s	11
blaast	bl:aa:st|bl:aː:st	30
blad	bl:a:d|bl:ɑ:t	52
bladeren	bl:a::d:e::r:e:n|bl:aː::d:ə::r:ə:	10
bladert	bl:a::d:e:rt|bl:aː::d:ə:rt	3
bladzij	bl:a:d:z:ij:|bl:ɑ:t:s:ɛi:	7
bladzijde	bl:a:d:z:ij::d:e:|bl:ɑ:t:s:ɛi::d:ə:	18
bladzijden	bl:a:d:z:ij::d:e:n|bl:ɑ:t:s:ɛi::d:ə:	2
blaf	bl:a:f|bl:ɑ:f	2
blaffen	bl:a:f:f:e:n|bl:ɑ::f:ə:	11
blaffend	bl:a:f:f:e:nd|bl:ɑ::f:ə:nt	2
blaft	bl:a:ft|bl:ɑ:ft	38
blaren	bl:a::r:e:n|bl:aː::r:ə:	5
blauw	bl:au:w|bl:ɑu:w	76
blauwe	bl:au::w:e:|bl:ɑu::w:ə:	46
blazen	bl:a::z:e:n|bl:aː::z:ə:	11
bleef	bl:ee:f|bl:eː:f	21
bleek	bl:ee:k|bl:eː:k	15
bleke	bl:e::k:e:|bl:eː::k:ə:	3
bleven	bl:e::v:e:n|bl:eː::v:ə:	5
blij	bl:ij:|bl:ɛi:	337
blijf	bl:ij:f|bl:ɛi:f	84
blijft	bl:ij:ft|bl:ɛi:ft	165
blijven	bl:ij::v:e:n|bl:ɛi::v:ə:	102
blik	bl:i:k|bl:ɪ:k	25
blikje	bl:i:k:j:e:|bl:ɪ:k:j:ə:	8
bliksem	bl:i:k:s:e:m|bl:ɪ:k:s:ə:m	6
blind	bl:i:nd|bl:ɪ:nt	3
blinken	bl:i:n:k:e:n|bl:ɪ:ŋ:k:ə:	2
blinkt	bl:i:nkt|bl:ɪ:ŋkt	3
bloed	bl:oe:d|bl:uː:t	53
bloedt	bl:oe:dt|bl:uː:t	7
bloei	bl:oe:i|bl:uː:j	6
bloeit	bl:oe:it|bl:uː:jt	3
bloem	bl:oe:m|bl:uː:m	58
bloembak	bl:oe:m:b:a:k|bl:uː:m:b:ɑ:k	5
bloemen	bl:oe::m:e:n|bl:uː::m:ə:	49
bloemetjes	bl:oe::m:e::tj:e:s|bl:uː::m:ə::tj:ə:s	2
bloemkool	bl:oe:m:k:oo:l|bl:uː:m:k:oː:l	4
bloempje	bl:oe:m:pj:e:|bl:uː:m:pj:ə:	3
bloempjes	bl:oe:m:pj:e:s|bl:uː:m:pj:ə:s	3
bloempot	bl:oe:m:p:o:t|bl:uː:m:p:ɔ:t	5
bloes	bl:oe:s|bl:uː:s	15
blok	bl:o:k|bl:ɔ:k	8
blokfluit	bl:o:k:fl:ui:t|bl:ɔ:k:fl:œy:t	15
blokje	bl:o:k:j:e:|bl:ɔ:k:j:ə:	5
blokjes	bl:o:k:j:e:s|bl:ɔ:k:j:ə:s	2
blokken	bl:o:k:k:e:n|bl:ɔ::k:ə:	8
blokkendoos	bl:o:k:k:e:n:d:oo:s|bl:ɔ::k:ə::d:oː:s	4
blond	bl:o:nd|bl:ɔ:nt	6
blonde	bl:o:n:d:e:|bl:ɔ:n:d:ə:	4
blonken	bl:o:n:k:e:n|bl:ɔ:ŋ:k:ə:	2
bloost	bl:oo:st|bl:oː:st	2
bloot	bl:oo:t|bl:oː:t	9
blootje	bl:oo:t:j:e:|bl:oː:t:j:ə:	2
blote	bl:o::t:e:|bl:oː::t:ə:	9
blussen	bl:u:s:s:e:n|bl:ʉ::s:ə:	3
bob	b:o:b|b:ɔ:p	43
bobbel	b:o:b:b:e:l|b:ɔ::b:ə:l	5
bobbeltjes	b:o:b:b:e:l:tj:e:s|b:ɔ::b:ə:l:tj:ə:s	2
bocht	b:o:cht|b:ɔ:çt	30
bochten	b:o:ch:t:e:n|b:ɔ:ç:t:ə:	3
bode	b:o::d:e:|b:oː::d:ə:	4
bodem	b:o::d:e:m|b:oː::d:ə:m	20
boe	b:oe:|b:uː:	63
boef	b:oe:f|b:uː:f	203
boefje	b:oe:f:j:e:|b:uː:f:j:ə:	13
boeg	b:oe:g|b:uː:ç	4
boei	b:oe:i|b:uː:j	14
boek	b:oe:k|b:uː:k	760
boeken	b:oe::k:e:n|b:uː::k:ə:	87
boekenkast	b:oe::k:e:n:k:a:st|b:uː::k:ə::k:ɑ:st	12
boekentas	b:oe::k:e:n:t:a:s|b:uː::k:ə::t:ɑ:s	2
boekje	b:oe:k:j:e:|b:uː:k:j:ə:	15
boekwinkel	b:oe:k:w:i:n:k:e:l|b:uː:k:w:ɪ:ŋ:k:ə:l	3
boel	b:oe:l|b:uː:l	8
boem	b:oe:m|b:uː:m	99
boen	b:oe:n|b:uː:n	15
boenen	b:oe::n:e:n|b:uː::n:ə:	5
boent	b:oe:nt|b:uː:nt	9
boer	b:oe:r|b:uː:r	202
boerderij	b:oe:r:d:e::r:ij:|b:uː:r:d:ə::r:ɛi:	14
boeren	b:oe::r:e:n|b:uː::r:ə:	10
boerin	b:oe::r:i:n|b:uː::r:ɪ:n	6
boeven	b:oe::v:e:n|b:uː::v:ə:	12
bof	b:o:f|b:ɔ:f	7
boffen	b:o:f:f:e:n|b:ɔ::f:ə:	2
boft	b:o:ft|b:ɔ:ft	7
bok	b:o:k|b:ɔ:k	100
bol	b:o:l|b:ɔ:l	70
bolle	b:o:l:l:e:|b:ɔ::l:ə:	8
bolletje	b:o:l:l:e::tj:e:|b:ɔ::l:ə::tj:ə:	5
bolletjes	b:o:l:l:e::tj:e:s|b:ɔ::l:ə::tj:ə:s	3
bom	b:o:m|b:ɔ:m	42
bomen	b:o::m:e:n|b:oː::m:ə:	61
bon	b:o:n|b:ɔ:n	27
bonbons	b:o:n:b:o:ns|b:ɔ:m:b:ɔ:ns	8
bonen	b:o::n:e:n|b:oː::n:ə:	11
bonk	b:o:nk|b:ɔ:ŋk	11
bonken	b:o:n:k:e:n|b:ɔ:ŋ:k:ə:	4
bonkt	b:o:nkt|b:ɔ:ŋkt	9
bons	b:o:ns|b:ɔ:ns	8
bonst	b:o:nst|b:ɔ:nst	5
bont	b:o:nt|b:ɔ:nt	6
bonzend	b:o:n:z:e:nd|b:ɔ:n:z:ə:nt	2
boodschap	b:oo:d:sch:a:p|b:oː:t:sç:ɑ:p	6
boodschappen	b:oo:d:sch:a:p:p:e:n|b:oː:t:sç:ɑ::p:ə:	13
boog	b:oo:g|b:oː:ç	23
boom	b:oo:m|b:oː:m	530
boompje	b:oo:m:pj:e:|b:oː:m:pj:ə:	8
boomstam	b:oo:m:st:a:m|b:oː:m:st:ɑ:m	4
boomstronk	b:oo:m:str:o:nk|b:oː:m:str:ɔ:ŋk	3
boon	b:oo:n|b:oː:n	31
boontje	b:oo:n:tj:e:|b:oː:n:tj:ə:	4
boontjes	b:oo:n:tj:e:s|b:oː:n:tj:ə:s	3
boor	b:oo:r|b:oː:r	45
boord	b:oo:rd|b:oː:rt	18
boormachine	b:oo:r:m:a::ch:i::n:e:|b:oː:r:m:ɑ::ʃ:iː::n:ə:	2
boort	b:oo:rt|b:oː:rt	8
boos	b:oo:s|b:oː:s	534
boot	b:oo:t|b:oː:t	414
bootje	b:oo:t:j:e:|b:oː:t:j:ə:	27
bord	b:o:rd|b:ɔ:rt	65
borden	b:o:r:d:e:n|b:ɔ:r:d:ə:	8
bordje	b:o:rd:j:e:|b:ɔ:rt:j:ə:	10
bordjes	b:o:rd:j:e:s|b:ɔ:rt:j:ə:s	7
boren	b:o::r:e:n|b:oː::r:ə:	6
borrelt	b:o:r:r:e:lt|b:ɔ::r:ə:lt	2
borst	b:o:rst|b:ɔ:rst	11
borstel	b:o:r:st:e:l|b:ɔ:r:st:ə:l	3
borstels	b:o:r:st:e:ls|b:ɔ:r:st:ə:ls	4
bos	b:o:s|b:ɔ:s	457
bosje	b:o:s:j:e:|b:ɔ:s:j:ə:	12
bosjes	b:o:s:j:e:s|b:ɔ:s:j:ə:s	6
bospad	b:o:s:p:a:d|b:ɔ:s:p:ɑ:t	2
bossen	b:o:s:s:e:n|b:ɔ::s:ə:	5
bot	b:o:t|b:ɔ:t	51
boten	b:o::t:e:n|b:oː::t:ə:	24
boter	b:o::t:e:r|b:oː::t:ə:r	14
boterham	b:o::t:e:r:h:a:m|b:oː::t:ə:r:h:ɑ:m	5
boterhammen	b:o::t:e:r:h:a:m:m:e:n|b:oː::t:ə:r:h:ɑ::m:ə:	4
botje	b:o:t:j:e:|b:ɔ:t:j:ə:	6
botjes	b:o:t:j:e:s|b:ɔ:t:j:ə:s	10
bots	b:o:ts|b:ɔ:ts	4
botsen	b:o:t:s:e:n|b:ɔ:t:s:ə:	7
botsing	b:o:t:s:i:ng|b:ɔ:t:s:ɪ:ŋ	7
botst	b:o:tst|b:ɔ:tst	18
botste	b:o:t:st:e:|b:ɔ:t:st:ə:	2
botste	b:o:t:st:e:|b:ɔ:ts:t:ə:	2
botten	b:o:t:t:e:n|b:ɔ::t:ə:	12
bout	b:ou:t|b:ɑu:t	4
bouten	b:ou::t:e:n|b:ɑu::t:ə:	2
bouw	b:ou:w|b:ɑu:w	13
bouwden	b:ou:w:d:e:n|b:ɑu:w:d:ə:	2
bouwen	b:ou::w:e:n|b:ɑu::w:ə:	18
bouwt	b:ou:wt|b:ɑu:wt	10
boven	b:o::v:e:n|b:oː::v:ə:	177
bovenaan	b:o::v:e:n::aa:n|b:oː::v:ə:::aː:n	3
bovendien	b:o::v:e:n:d:ie:n|b:oː::v:ə::d:iː:n	2
bovenkant	b:o::v:e:n:k:a:nt|b:oː::v:ə::k:ɑ:nt	3
bovenop	b:o::v:e:n::o:p|b:oː::v:ə:::ɔ:p	7
bovenste	b:o::v:e:n:st:e:|b:oː::v:ə:s:t:ə:	2
boze	b:o::z:e:|b:oː::z:ə:	22
braaf	br:aa:f|br:aː:f	9
braak	br:aa:k|br:aː:k	3
braam	br:aa:m|br:aː:m	8
bracht	br:a:cht|br:ɑ:çt	10
brak	br:a:k|br:ɑ:k	12
braken	br:a::k:e:n|br:aː::k:ə:	3
bram	br:a:m|br:ɑ:m	117
brand	br:a:nd|br:ɑ:nt	16
brandende	br:a:n:d:e:n:d:e:|br:ɑ:n:d:ə:n:d:ə:	2
brandt	br:a:ndt|br:ɑ:nt	16
brandweer	br:a:nd:w:ee:r|br:ɑ:nd:w:eː:r	8
bravo	br:a::v:o:|br:aː::v:oː:	5
brede	br:e::d:e:|br:eː::d:ə:	8
breder	br:e::d:e:r|br:eː::d:ə:r	3
breed	br:ee:d|br:eː:t	10
breek	br:ee:k|br:eː:k	4
breekt	br:ee:kt|br:eː:kt	18
breken	br:e::k:e:n|br:eː::k:ə:	11
breng	br:e:ng|br:ɛ:ŋ	26
brengen	br:e:n:g:e:n|br:ɛ::ŋ:ə:	18
brengt	br:e:ngt|br:ɛ:ŋt	47
brief	br:ie:f|br:iː:f	132
briefje	br:ie:f:j:e:|br:iː:f:j:ə:	33
briefjes	br:ie:f:j:e:s|br:iː:f:j:ə:s	11
bries	br:ie:s|br:iː:s	2
briest	br:ie:st|br:iː:st	2
brieven	br:ie::v:e:n|br:iː::v:ə:	9
brievenbus	br:ie::v:e:n:b:u:s|br:iː::v:ə::b:ʉ:s	8
bril	br:i:l|br:ɪ:l	54
brillen	br:i:l:l:e:n|br:ɪ::l:ə:	2
brilletje	br:i:l:l:e::tj:e:|br:ɪ::l:ə::tj:ə:	2
brit	br:i:t|br:ɪ:t	154
broden	br:o::d:e:n|br:oː::d:ə:	3
broeden	br:oe::d:e:n|br:uː::d:ə:	8
broedt	br:oe:dt|br:uː:t	3
broek	br:oe:k|br:uː:k	113
broeken	br:oe::k:e:n|br:uː::k:ə:	11
broekje	br:oe:k:j:e:|br:uː:k:j:ə:	3
broekzak	br:oe:k:z:a:k|br:uː:k:s:ɑ:k	19
broekzakken	br:oe:k:z:a:k:k:e:n|br:uː:k:s:ɑ::k:ə:	4
broer	br:oe:r|br:uː:r	50
broers	br:oe:rs|br:uː:rs	20
broertje	br:oe:r:tj:e:|br:uː:r:tj:ə:	24
broertjes	br:oe:r:tj:e:s|br:uː:r:tj:ə:s	6
brok	br:o:k|br:ɔ:k	3
brokjes	br:o:k:j:e:s|br:ɔ:k:j:ə:s	5
brom	br:o:m|br:ɔ:m	4
bromde	br:o:m:d:e:|br:ɔ:m:d:ə:	4
bromfiets	br:o:m:f:ie:ts|br:ɔ:m:f:iː:ts	3
brommen	br:o:m:m:e:n|br:ɔ::m:ə:	2
brommer	br:o:m:m:e:r|br:ɔ::m:ə:r	29
bromt	br:o:mt|br:ɔ:mt	47
brood	br:oo:d|br:oː:t	90
broodje	br:oo:d:j:e:|br:oː:t:j:ə:	18
broodjes	br:oo:d:j:e:s|br:oː:t:j:ə:s	15
broodmes	br:oo:d:m:e:s|br:oː:d:m:ɛ:s	3
broodrooster	br:oo:d:r:oo:s:t:e:r|br:oː:d:r:oː:s:t:ə:r	2
broodtrommel	br:oo:d:tr:o:m:m:e:l|br:oː::tr:ɔ::m:ə:l	2
brug	br:u:g|br:ʉ:ç	41
bruggen	br:u:g:g:e:n|br:ʉ::ɣ:ə:	4
bruggetje	br:u:g:g:e::tj:e:|br:ʉ::ɣ:ə::tj:ə:	5
bruid	br:ui:d|br:œy:t	16
bruin	br:ui:n|br:œy:n	112
bruine	br:ui::n:e:|br:œy::n:ə:	28
bruiner	br:ui::n:e:r|br:œy::n:ə:r	3
brul	br:u:l|br:ʉ:l	6
brullen	br:u:l:l:e:n|br:ʉ::l:ə:	3
brult	br:u:lt|br:ʉ:lt	34
buggy	b:u:g:g:y:|b:ʉ::ɡ:iː:	5
bui	b:ui:|b:œy:	24
buidel	b:ui::d:e:l|b:œy::d:ə:l	3
buig	b:ui:g|b:œy:ç	4
buigen	b:ui::g:e:n|b:œy::ɣ:ə:	7
buiging	b:ui::g:i:ng|b:œy::ɣ:ɪ:ŋ	14
buigt	b:ui:gt|b:œy:çt	25
buik	b:ui:k|b:œy:k	274
buikje	b:ui:k:j:e:|b:œy:k:j:ə:	3
buikpijn	b:ui:k:p:ij:n|b:œy:k:p:ɛi:n	4
buil	b:ui:l|b:œy:l	17
builen	b:ui::l:e:n|b:œy::l:ə:	3
buis	b:ui:s|b:œy:s	10
buisje	b:ui:s:j:e:|b:œy:s:j:ə:	7
buit	b:ui:t|b:œy:t	22
buiten	b:ui::t:e:n|b:œy::t:ə:	184
buitenkant	b:ui::t:e:n:k:a:nt|b:œy::t:ə::k:ɑ:nt	7
buk	b:u:k|b:ʉ:k	10
bukken	b:u:k:k:e:n|b:ʉ::k:ə:	3
bukt	b:u:kt|b:ʉ:kt	24
bult	b:u:lt|b:ʉ:lt	5
bulten	b:u:l:t:e:n|b:ʉ:l:t:ə:	4
bungelen	b:u:n:g:e::l:e:n|b:ʉ::ŋ:ə::l:ə:	3
bureau	b:u::r:ea:u|b:yː::r:oː:	4
buren	b:u::r:e:n|b:yː::r:ə:	14
burgemeester	b:u:r:g:e::m:ee:s:t:e:r|b:ʉ:r:ɣ:ə::m:eː:s:t:ə:r	3
bus	b:u:s|b:ʉ:s	226
bushalte	b:u:s:h:a:l:t:e:|b:ʉ:s:h:ɑ:l:t:ə:	8
bussen	b:u:s:s:e:n|b:ʉ::s:ə:	7
buur	b:uu:r|b:yː:r	7
buurjongen	b:uu:r:j:o:n:g:e:n|b:yː:r:j:ɔ::ŋ:ə:	7
buurman	b:uu:r:m:a:n|b:yː:r:m:ɑ:n	54
buurt	b:uu:rt|b:yː:rt	41
buurvrouw	b:uu:r:vr:ou:w|b:yː:r:vr:ɑu:w	16
c	c::|s:eː:	7
cadeau	c:a::d:ea:u|k:aː::d:oː:	14
cadeautje	c:a::d:ea:u:tj:e:|k:aː::d:oː::tj:ə:	22
cadeautjes	c:a::d:ea:u:tj:e:s|k:aː::d:oː::tj:ə:s	3
camera	c:a::m:e::r:a:|k:aː::m:ə::r:aː:	2
camping	c:a:m:p:i:ng|k:ɛ:m:p:ɪ:ŋ	8
caravan	c:a::r:a::v:a:n|k:ɛ::r:ə::v:ɛ:n	3
carnaval	c:a:r:n:a::v:a:l|k:ɑ:r:n:aː::v:ɑ:l	2
cel	c:e:l|s:ɛ:l	9
cent	c:e:nt|s:ɛ:nt	5
centimeter	c:e:n:t:i::m:e::t:e:r|s:ɛ:n:t:iː::m:eː::t:ə:r	3
chauffeur	ch:au:f:f:eu:r|ʃ:oː::f:øː:r	4
chinees	ch:i::n:ee:s|ʃ:iː::n:eː:s	4
chips	ch:i:ps|tʃ:ɪ:ps	28
chocola	ch:o::c:o::l:a:|ʃ:oː::k:oː::l:aː:	4
chocolademelk	ch:o::c:o::l:a::d:e::m:e:lk|ʃ:oː::k:oː::l:aː::d:ə::m:ɛ:lk	2
circus	c:i:r:c:u:s|s:ɪ:r:k:ʉ:s	29
cirkel	c:i:r:k:e:l|s:ɪ:r:k:ə:l	14
cirkels	c:i:r:k:e:ls|s:ɪ:r:k:ə:ls	5
citroen	c:i::tr:oe:n|s:iː::tr:uː:n	5
citroensap	c:i::tr:oe:n:s:a:p|s:iː::tr:uː:n:s:ɑ:p	2
clown	cl:o:wn|kl:ɑu:n	9
club	cl:u:b|kl:ʉ:p	9
cockpit	c:o:ck:p:i:t|k:ɔ:k:p:ɪ:t	2
cola	c:o::l:a:|k:oː::l:aː:	5
computer	c:o:m:p:u::t:e:r|k:ɔ:m:pj:uː::t:ə:r	11
concert	c:o:n:c:e:rt|k:ɔ:n:s:ɛ:rt	4
d	d::|d:eː:	272
daag	d:aa:g|d:aː:ç	4
daagjes	d:aa:g:j:e:s|d:aː:ç:j:ə:s	2
daalt	d:aa:lt|d:aː:lt	8
daar	d:aa:r|d:aː:r	2192
daaraan	d:aa:r::aa:n|d:aː:r::aː:n	10
daarachter	d:aa:r::a:ch:t:e:r|d:aː:r::ɑ:ç:t:ə:r	5
daarbij	d:aa:r:b:ij:|d:aː:r:b:ɛi:	6
daardoor	d:aa:r:d:oo:r|d:aː:r:d:oː:r	15
daarin	d:aa:r::i:n|d:aː:r::ɪ:n	21
daarmee	d:aa:r:m:ee:|d:aː:r:m:eː:	39
daarna	d:aa:r:n:a:|d:aː:r:n:aː:	165
daarnaast	d:aa:r:n:aa:st|d:aː:r:n:aː:st	4
daarom	d:aa:r::o:m|d:aː:r::ɔ:m	110
daaronder	d:aa:r::o:n:d:e:r|d:aː:r::ɔ:n:d:ə:r	2
daarop	d:aa:r::o:p|d:aː:r::ɔ:p	18
daartussen	d:aa:r:t:u:s:s:e:n|d:aː:r:t:ʉ::s:ə:	2
daarvan	d:aa:r:v:a:n|d:aː:r:v:ɑ:n	14
daarvoor	d:aa:r:v:oo:r|d:aː:r:v:oː:r	10
dacht	d:a:cht|d:ɑ:çt	132
dachten	d:a:ch:t:e:n|d:ɑ:ç:t:ə:	6
dadelijk	d:a::d:e::l:ij:k|d:aː::d:ə::l:ə:k	5
dag	d:a:g|d:ɑ:ç	645
dagboek	d:a:g:b:oe:k|d:ɑ:ɣ:b:uː:k	25
dagen	d:a::g:e:n|d:aː::ɣ:ə:	37
dagenlang	d:a::g:e:n:l:a:ng|d:aː::ɣ:ə::l:ɑ:ŋ	2
dagje	d:a:g:j:e:|d:ɑ:ç:j:ə:	13
dak	d:a:k|d:ɑ:k	110
daken	d:a::k:e:n|d:aː::k:ə:	4
dakpan	d:a:k:p:a:n|d:ɑ:k:p:ɑ:n	3
dalen	d:a::l:e:n|d:aː::l:ə:	3
dame	d:a::m:e:|d:aː::m:ə:	19
dames	d:a::m:e:s|d:aː::m:ə:s	7
damp	d:a:mp|d:ɑ:mp	2
dan	d:a:n|d:ɑ:n	3343
dank	d:a:nk|d:ɑ:ŋk	48
dankzij	d:a:nk:z:ij:|d:ɑ:ŋk:s:ɛi:	5
dans	d:a:ns|d:ɑ:ns	33
dansen	d:a:n:s:e:n|d:ɑ:n:s:ə:	33
dansend	d:a:n:s:e:nd|d:ɑ:n:s:ə:nt	2
danseres	d:a:n:s:e::r:e:s|d:ɑ:n:s:ə::r:ɛ:s	6
dansje	d:a:ns:j:e:|d:ɑ:ns:j:ə:	14
danst	d:a:nst|d:ɑ:nst	31
danste	d:a:n:st:e:|d:ɑ:ns:t:ə:	2
dapper	d:a:p:p:e:r|d:ɑ::p:ə:r	18
darmen	d:a:r:m:e:n|d:ɑ:r:m:ə:	3
das	d:a:s|d:ɑ:s	59
dat	d:a:t|d:ɑ:t	5027
de	d:e:|d:ə:	18368
deden	d:e::d:e:n|d:eː::d:ə:	12
deed	d:ee:d|d:eː:t	103
deeg	d:ee:g|d:eː:ç	43
deel	d:ee:l|d:eː:l	16
deelt	d:ee:lt|d:eː:lt	11
deen	d:ee:n|d:eː:n	2
deftig	d:e:f:t:i:g|d:ɛ:f:t:ə:ç	8
deftige	d:e:f:t:i::g:e:|d:ɛ:f:t:ə::ɣ:ə:	4
dek	d:e:k|d:ɛ:k	50
dekbed	d:e:k:b:e:d|d:ɛ:ɡ:b:ɛ:t	8
deken	d:e::k:e:n|d:eː::k:ə:	8
dekens	d:e::k:e:ns|d:eː::k:ə:ns	8
dekker	d:e:k:k:e:r|d:ɛ::k:ə:r	3
deksel	d:e:k:s:e:l|d:ɛ:k:s:ə:l	24
deksels	d:e:k:s:e:ls|d:ɛ:k:s:ə:ls	3
dekt	d:e:kt|d:ɛ:kt	10
del	d:e:l|d:ɛ:l	13
delen	d:e::l:e:n|d:eː::l:ə:	7
den	d:e:n|d:ɛ:n	27
denk	d:e:nk|d:ɛ:ŋk	165
denken	d:e:n:k:e:n|d:ɛ:ŋ:k:ə:	57
denkt	d:e:nkt|d:ɛ:ŋkt	431
der	d:e:r|d:ɛ:r	14
derde	d:e:r:d:e:|d:ɛ:r:d:ə:	19
dertien	d:e:r:t:ie:n|d:ɛ:r:t:iː:n	10
dertig	d:e:r:t:i:g|d:ɛ:r:t:ə:ç	11
des	d:e:s|d:ɛ:s	2
deuk	d:eu:k|d:øː:k	36
deuken	d:eu::k:e:n|d:øː::k:ə:	2
deukje	d:eu:k:j:e:|d:øː:k:j:ə:	2
deun	d:eu:n|d:øː:n	3
deuntje	d:eu:n:tj:e:|d:øː:n:tj:ə:	3
deur	d:eu:r|d:øː:r	395
deurbel	d:eu:r:b:e:l|d:øː:r:b:ɛ:l	5
deuren	d:eu::r:e:n|d:øː::r:ə:	16
deurkruk	d:eu:r:kr:u:k|d:øː:r:kr:ʉ:k	6
deurmat	d:eu:r:m:a:t|d:øː:r:m:ɑ:t	8
deurtje	d:eu:r:tj:e:|d:øː:r:tj:ə:	7
deze	d:e::z:e:|d:eː::z:ə:	154
dezelfde	d:e::z:e:lf:d:e:|d:ə::z:ɛ:lv:d:ə:	14
dicht	d:i:cht|d:ɪ:çt	208
dichtbij	d:i:cht:b:ij:|d:ɪ:ɣd:b:ɛi:	19
dichtdoen	d:i:cht:d:oe:n|d:ɪ:ɣ:d:uː:n	3
dichte	d:i:ch:t:e:|d:ɪ:ç:t:ə:	7
dichter	d:i:ch:t:e:r|d:ɪ:ç:t:ə:r	4
dichterbij	d:i:ch:t:e:r:b:ij:|d:ɪ:ç:t:ə:r:b:ɛi:	9
dichtgedaan	d:i:cht:g:e::d:aa:n|d:ɪ:çt:ç:ə::d:aː:n	5
die	d:ie:|d:iː:	2278
dief	d:ie:f|d:iː:f	109
dienaar	d:ie::n:aa:r|d:iː::n:aː:r	2
dienblad	d:ie:n:bl:a:d|d:iː:m:bl:ɑ:t	3
dienst	d:ie:nst|d:iː:nst	3
diep	d:ie:p|d:iː:p	91
diepe	d:ie::p:e:|d:iː::p:ə:	20
dieper	d:ie::p:e:r|d:iː::p:ə:r	9
diepte	d:ie:p:t:e:|d:iː:p:t:ə:	2
diepvries	d:ie:p:vr:ie:s|d:iː:p:fr:iː:s	2
dier	d:ie:r|d:iː:r	199
dieren	d:ie::r:e:n|d:iː::r:ə:	155
dierendag	d:ie::r:e:n:d:a:g|d:iː::r:ə::d:ɑ:ç	2
dierentuin	d:ie::r:e:n:t:ui:n|d:iː::r:ə::t:œy:n	20
diertje	d:ie:r:tj:e:|d:iː:r:tj:ə:	5
dieven	d:ie::v:e:n|d:iː::v:ə:	14
dij	d:ij:|d:ɛi:	4
dijk	d:ij:k|d:ɛi:k	26
dik	d:i:k|d:ɪ:k	116
dikke	d:i:k:k:e:|d:ɪ::k:ə:	149
dikker	d:i:k:k:e:r|d:ɪ::k:ə:r	9
dikst	d:i:kst|d:ɪ:kst	5
dikste	d:i:k:st:e:|d:ɪ:k:st:ə:	4
dil	d:i:l|d:ɪ:l	3
ding	d:i:ng|d:ɪ:ŋ	64
dingen	d:i:n:g:e:n|d:ɪ::ŋ:ə:	78
dinsdag	d:i:ns:d:a:g|d:ɪ:nz:d:ɑ:ç	17
dip	d:i:p|d:ɪ:p	5
diploma	d:i::pl:o::m:a:|d:iː::pl:oː::m:aː:	2
direct	d:i::r:e:ct|d:iː::r:ɛ:kt	2
directeur	d:i::r:e:c:t:eu:r|d:iː::r:ɛ:k:t:øː:r	5
dirk	d:i:rk|d:ɪ:rk	7
dis	d:i:s|d:ɪ:s	3
dit	d:i:t|d:ɪ:t	1008
do	d:o:|d:oː:	6
dobbelsteen	d:o:b:b:e:l:st:ee:n|d:ɔ::b:ə:l:st:eː:n	12
dochter	d:o:ch:t:e:r|d:ɔ:ç:t:ə:r	8
dode	d:o::d:e:|d:oː::d:ə:	8
doden	d:o::d:e:n|d:oː::d:ə:	2
doe	d:oe:|d:uː:	563
doeg	d:oe:g|d:uː:ç	4
doek	d:oe:k|d:uː:k	106
doeken	d:oe::k:e:n|d:uː::k:ə:	3
doel	d:oe:l|d:uː:l	21
doelpunt	d:oe:l:p:u:nt|d:uː:l:p:ʉ:nt	12
doen	d:oe:n|d:uː:n	721
does	d:oe:s|d:uː:s	13
doet	d:oe:t|d:uː:t	937
dof	d:o:f|d:ɔ:f	3
doffe	d:o:f:f:e:|d:ɔ::f:ə:	3
doffer	d:o:f:f:e:r|d:ɔ::f:ə:r	2
dok	d:o:k|d:ɔ:k	5
dokter	d:o:k:t:e:r|d:ɔ:k:t:ə:r	48
dol	d:o:l|d:ɔ:l	85
dolblij	d:o:l:bl:ij:|d:ɔ:l:bl:ɛi:	2
dolfijn	d:o:l:f:ij:n|d:ɔ:l:f:ɛi:n	5
dolgraag	d:o:l:gr:aa:g|d:ɔ:l:ɣr:aː:ç	4
dolk	d:o:lk|d:ɔ:lk	13
dolle	d:o:l:l:e:|d:ɔ::l:ə:	2
dollen	d:o:l:l:e:n|d:ɔ::l:ə:	2
dom	d:o:m|d:ɔ:m	64
domkop	d:o:m:k:o:p|d:ɔ:m:k:ɔ:p	4
domme	d:o:m:m:e:|d:ɔ::m:ə:	5
donder	d:o:n:d:e:r|d:ɔ:n:d:ə:r	9
donderdag	d:o:n:d:e:r:d:a:g|d:ɔ:n:d:ə:r:d:ɑ:ç	19
donderen	d:o:n:d:e::r:e:n|d:ɔ:n:d:ə::r:ə:	2
dondert	d:o:n:d:e:rt|d:ɔ:n:d:ə:rt	3
dong	d:o:ng|d:ɔ:ŋ	3
donker	d:o:n:k:e:r|d:ɔ:ŋ:k:ə:r	125
donkerbruin	d:o:n:k:e:r:br:ui:n|d:ɔ:ŋ:k:ə:r:br:œy:n	2
donkerder	d:o:n:k:e:r:d:e:r|d:ɔ:ŋ:k:ə:r:d:ə:r	2
donkere	d:o:n:k:e::r:e:|d:ɔ:ŋ:k:ə::r:ə:	16
donkergroen	d:o:n:k:e:r:gr:oe:n|d:ɔ:ŋ:k:ə:r:ɣr:uː:n	2
donkergroene	d:o:n:k:e:r:gr:oe::n:e:|d:ɔ:ŋ:k:ə:r:ɣr:uː::n:ə:	3
dons	d:o:ns|d:ɔ:ns	3
dood	d:oo:d|d:oː:t	61
doodging	d:oo:d:g:i:ng|d:oː:t:ç:ɪ:ŋ	2
doodmoe	d:oo:d:m:oe:|d:oː:d:m:uː:	4
doodstil	d:oo:d:st:i:l|d:oː:t:st:ɪ:l	8
doof	d:oo:f|d:oː:f	5
dooft	d:oo:ft|d:oː:ft	2
dooier	d:oo:i::e:r|d:oː::j:ə:r	5
dooit	d:oo:it|d:oː:jt	3
dook	d:oo:k|d:oː:k	7
doolhof	d:oo:l:h:o:f|d:oː:l:h:ɔ:f	30
doop	d:oo:p|d:oː:p	4
door	d:oo:r|d:oː:r	926
doordat	d:oo:r:d:a:t|d:oː:r:d:ɑ:t	5
doorgaan	d:oo:r:g:aa:n|d:oː:r:ɣ:aː:n	2
doorheen	d:oo:r:h:ee:n|d:oː:r:h:eː:n	12
doorlopen	d:oo:r:l:o::p:e:n|d:oː:r:l:oː::p:ə:	3
doornat	d:oo:r:n:a:t|d:oː:r:n:ɑ:t	2
doornen	d:oo:r:n:e:n|d:oː:r:n:ə:	2
doorsnijden	d:oo:r:sn:ij::d:e:n|d:oː:r:sn:ɛi::d:ə:	2
doorzocht	d:oo:r:z:o:cht|d:oː:r:z:ɔ:çt	2
doos	d:oo:s|d:oː:s	382
doosje	d:oo:s:j:e:|d:oː:s:j:ə:	51
doosjes	d:oo:s:j:e:s|d:oː:s:j:ə:s	15
dop	d:o:p|d:ɔ:p	15
doppen	d:o:p:p:e:n|d:ɔ::p:ə:	2
dorp	d:o:rp|d:ɔ:rp	94
dorpen	d:o:r:p:e:n|d:ɔ:r:p:ə:	3
dorst	d:o:rst|d:ɔ:rst	26
dozen	d:o::z:e:n|d:oː::z:ə:	10
draad	dr:aa:d|dr:aː:t	35
draadjes	dr:aa:d:j:e:s|dr:aː:t:j:ə:s	5
draaft	dr:aa:ft|dr:aː:ft	5
draag	dr:aa:g|dr:aː:ç	11
draagt	dr:aa:gt|dr:aː:çt	45
draai	dr:aa:i|dr:aː:j	51
draaide	dr:aa:i:d:e:|dr:aː:j:d:ə:	5
draaien	dr:aa:i::e:n|dr:aː::j:ə:	25
draait	dr:aa:it|dr:aː:jt	86
draak	dr:aa:k|dr:aː:k	146
draden	dr:a::d:e:n|dr:aː::d:ə:	2
dragen	dr:a::g:e:n|dr:aː::ɣ:ə:	17
draken	dr:a::k:e:n|dr:aː::k:ə:	9
drank	dr:a:nk|dr:ɑ:ŋk	3
drankje	dr:a:nk:j:e:|dr:ɑ:ŋk:j:ə:	6
drankjes	dr:a:nk:j:e:s|dr:ɑ:ŋk:j:ə:s	4
dreef	dr:ee:f|dr:eː:f	8
dreigend	dr:ei::g:e:nd|dr:ɛi::ɣ:ə:nt	2
drempel	dr:e:m:p:e:l|dr:ɛ:m:p:ə:l	9
dribbelt	dr:i:b:b:e:lt|dr:ɪ::b:ə:lt	2
drie	dr:ie:|dr:iː:	246
driehoek	dr:ie::h:oe:k|dr:iː::h:uː:k	2
drijf	dr:ij:f|dr:ɛi:f	2
drijfnat	dr:ij:f:n:a:t|dr:ɛi:f:n:ɑ:t	2
drijft	dr:ij:ft|dr:ɛi:ft	13
drijven	dr:ij::v:e:n|dr:ɛi::v:ə:	7
dril	dr:i:l|dr:ɪ:l	18
dringend	dr:i:n:g:e:nd|dr:ɪ::ŋ:ə:nt	2
dringt	dr:i:ngt|dr:ɪ:ŋt	3
drink	dr:i:nk|dr:ɪ:ŋk	19
drinken	dr:i:n:k:e:n|dr:ɪ:ŋ:k:ə:	50
drinkt	dr:i:nkt|dr:ɪ:ŋkt	17
drinkwater	dr:i:nk:w:a::t:e:r|dr:ɪ:ŋk:w:aː::t:ə:r	2
droeg	dr:oe:g|dr:uː:ç	3
droevig	dr:oe::v:i:g|dr:uː::v:ə:ç	11
droge	dr:o::g:e:|dr:oː::ɣ:ə:	3
drogen	dr:o::g:e:n|dr:oː::ɣ:ə:	5
dromen	dr:o::m:e:n|dr:oː::m:ə:	12
dronk	dr:o:nk|dr:ɔ:ŋk	4
dronken	dr:o:n:k:e:n|dr:ɔ:ŋ:k:ə:	2
droog	dr:oo:g|dr:oː:ç	43
droogt	dr:oo:gt|dr:oː:çt	3
droom	dr:oo:m|dr:oː:m	51
droomde	dr:oo:m:d:e:|dr:oː:m:d:ə:	3
droomt	dr:oo:mt|dr:oː:mt	29
drop	dr:o:p|dr:ɔ:p	13
dropje	dr:o:p:j:e:|dr:ɔ:p:j:ə:	6
druif	dr:ui:f|dr:œy:f	12
druipt	dr:ui:pt|dr:œy:pt	6
druk	dr:u:k|dr:ʉ:k	98
drukke	dr:u:k:k:e:|dr:ʉ::k:ə:	10
drukken	dr:u:k:k:e:n|dr:ʉ::k:ə:	6
drukste	dr:u:k:st:e:|dr:ʉ:k:st:ə:	2
drukt	dr:u:kt|dr:ʉ:kt	33
drukte	dr:u:k:t:e:|dr:ʉ:k:t:ə:	10
drummen	dr:u:m:m:e:n|dr:ʉ::m:ə:	4
drumt	dr:u:mt|dr:ʉ:mt	4
druppel	dr:u:p:p:e:l|dr:ʉ::p:ə:l	4
druppels	dr:u:p:p:e:ls|dr:ʉ::p:ə:ls	5
drupt	dr:u:pt|dr:ʉ:pt	7
dubbel	d:u:b:b:e:l|d:ʉ::b:ə:l	10
dubbele	d:u:b:b:e::l:e:|d:ʉ::b:ə::l:ə:	3
duf	d:u:f|d:ʉ:f	4
duidelijk	d:ui::d:e::l:ij:k|d:œy::d:ə::l:ə:k	13
duif	d:ui:f|d:œy:f	107
duik	d:ui:k|d:œy:k	34
duikboot	d:ui:k:b:oo:t|d:œy:ɡ:b:oː:t	24
duikbril	d:ui:k:br:i:l|d:œy:ɡ:br:ɪ:l	8
duiken	d:ui::k:e:n|d:œy::k:ə:	17
duiker	d:ui::k:e:r|d:œy::k:ə:r	5
duikplank	d:ui:k:pl:a:nk|d:œy:k:pl:ɑ:ŋk	7
duikt	d:ui:kt|d:œy:kt	45
duim	d:ui:m|d:œy:m	37
duimen	d:ui::m:e:n|d:œy::m:ə:	5
duimpje	d:ui:m:pj:e:|d:œy:m:pj:ə:	8
duin	d:ui:n|d:œy:n	25
duinen	d:ui::n:e:n|d:œy::n:ə:	10
duister	d:ui:s:t:e:r|d:œy:s:t:ə:r	3
duitse	d:ui:t:s:e:|d:œy:t:s:ə:	2
duiven	d:ui::v:e:n|d:œy::v:ə:	13
duizelig	d:ui::z:e::l:i:g|d:œy::z:ə::l:ə:ç	7
duizend	d:ui::z:e:nd|d:œy::z:ə:nt	17
duizenden	d:ui::z:e:n:d:e:n|d:œy::z:ə:n:d:ə:	2
duizendpoot	d:ui::z:e:nd:p:oo:t|d:œy::z:ə:nt:p:oː:t	3
dun	d:u:n|d:ʉ:n	48
dunne	d:u:n:n:e:|d:ʉ::n:ə:	7
dunner	d:u:n:n:e:r|d:ʉ::n:ə:r	3
dunst	d:u:nst|d:ʉ:nst	4
dure	d:u::r:e:|d:yː::r:ə:	5
duren	d:u::r:e:n|d:yː::r:ə:	7
durf	d:u:rf|d:ʉ:rf	38
durfde	d:u:rf:d:e:|d:ʉ:rv:d:ə:	4
durft	d:u:rft|d:ʉ:rft	61
durven	d:u:r:v:e:n|d:ʉ:r:v:ə:	15
dus	d:u:s|d:ʉ:s	281
dut	d:u:t|d:ʉ:t	7
dutje	d:u:t:j:e:|d:ʉ:t:j:ə:	12
duur	d:uu:r|d:yː:r	29
duurde	d:uu:r:d:e:|d:yː:r:d:ə:	5
duurste	d:uu:r:st:e:|d:yː:r:st:ə:	2
duurt	d:uu:rt|d:yː:rt	82
duw	d:u:w|d:yː:w	26
duwde	d:u:w:d:e:|d:yː:w:d:ə:	3
duwen	d:u::w:e:n|d:yː::w:ə:	18
duwt	d:u:wt|d:yː:wt	66
duwtje	d:u:w:tj:e:|d:yː:w:tj:ə:	2
dwaal	dw:aa:l|dw:aː:l	2
dwarrelt	dw:a:r:r:e:lt|dw:ɑ::r:ə:lt	3
dwars	dw:a:rs|dw:ɑ:rs	7
dwazen	dw:a::z:e:n|dw:aː::z:ə:	2
dweil	dw:ei:l|dw:ɛi:l	3
dweilt	dw:ei:lt|dw:ɛi:lt	3
dwerg	dw:e:rg|dw:ɛ:rç	52
e	:e:|:eː:	60
eb	:e:b|:ɛ:p	12
echt	:e:cht|:ɛ:çt	399
echte	:e:ch:t:e:|:ɛ:ç:t:ə:	78
ede	:e::d:e:|:eː::d:ə:	4
eekhoorn	:ee:k:h:oo:rn|:eː:k:h:oː:rn	124
een	:ee:n|:eː:n	15784
een	:ee:n|:ə:n	15784
eend	:ee:nd|:eː:nt	89
eenden	:ee:n:d:e:n|:eː:n:d:ə:	25
eendje	:ee:nd:j:e:|:eː:nt:j:ə:	5
eendjes	:ee:nd:j:e:s|:eː:nt:j:ə:s	5
eenmaal	:ee:n:m:aa:l|:eː:n:m:aː:l	12
eens	:ee:ns|:eː:ns	659
eentje	:ee:n:tj:e:|:eː:n:tj:ə:	25
eenzaam	:ee:n:z:aa:m|:eː:n:z:aː:m	3
eer	:ee:r|:eː:r	6
eerder	:ee:r:d:e:r|:eː:r:d:ə:r	14
eerlijk	:ee:r:l:ij:k|:eː:r:l:ə:k	22
eerst	:ee:rst|:eː:rst	298
eerste	:ee:r:st:e:|:eː:r:st:ə:	104
eet	:ee:t|:eː:t	662
eetbaar	:ee:t:b:aa:r|:eː:d:b:aː:r	5
eethuis	:ee:t:h:ui:s|:eː:t:h:œy:s	17
eeuw	:ee:uw|:eː:w	20
eeuwig	:ee:uw::i:g|:eː::w:ə:ç	2
egel	:e::g:e:l|:eː::ɣ:ə:l	47
egels	:e::g:e:ls|:eː::ɣ:ə:ls	4
eh	:e:h|:ə:	28
ei	:ei:|:ɛi:	274
eieren	:ei:::e::r:e:n|:ɛi::j:ə::r:ə:	23
eigeel	:ei::g:ee:l|:ɛi::ɣ:eː:l	4
eigen	:ei::g:e:n|:ɛi::ɣ:ə:	91
eigenlijk	:ei::g:e:n:l:ij:k|:ɛi::ɣ:ə::l:ə:k	41
eik	:ei:k|:ɛi:k	25
eikels	:ei::k:e:ls|:ɛi::k:ə:ls	17
eiland	:ei::l:a:nd|:ɛi::l:ɑ:nt	68
eind	:ei:nd|:ɛi:nt	42
einde	:ei:n:d:e:|:ɛi:n:d:ə:	12
eindelijk	:ei:n:d:e::l:ij:k|:ɛi:n:d:ə::l:ə:k	35
eindje	:ei:nd:j:e:|:ɛi:nt:j:ə:	8
eitje	:ei::tj:e:|:ɛi::tj:ə:	3
eitjes	:ei::tj:e:s|:ɛi::tj:ə:s	35
eiwit	:ei::w:i:t|:ɛi::w:ɪ:t	3
ekster	:e:k:st:e:r|:ɛ:k:st:ə:r	2
elastiekjes	:e::l:a:s:t:ie:k:j:e:s|:eː::l:ɑ:s:t:iː:k:j:ə:s	4
elf	:e:lf|:ɛ:lf	19
elk	:e:lk|:ɛ:lk	121
elkaar	:e:l:k:aa:r|:ɛ:l:k:aː:r	221
elke	:e:l:k:e:|:ɛ:l:k:ə:	181
ellen	:e:l:l:e:n|:ɛ::l:ə:	13
ellende	:e:l:l:e:n:d:e:|:ɛ::l:ɛ:n:d:ə:	4
els	:e:ls|:ɛ:ls	62
emmer	:e:m:m:e:r|:ɛ::m:ə:r	29
emmers	:e:m:m:e:rs|:ɛ::m:ə:rs	6
en	:e:n|:ɛ:n	9414
ene	:e::n:e:|:eː::n:ə:	42
eng	:e:ng|:ɛ:ŋ	108
enge	:e:n:g:e:|:ɛ::ŋ:ə:	13
engel	:e:n:g:e:l|:ɛ::ŋ:ə:l	6
engels	:e:n:g:e:ls|:ɛ::ŋ:ə:ls	10
engeltje	:e:n:g:e:l:tj:e:|:ɛ::ŋ:ə:l:tj:ə:	5
enige	:e::n:i::g:e:|:eː::n:ə::ɣ:ə:	7
enkel	:e:n:k:e:l|:ɛ:ŋ:k:ə:l	5
enkele	:e:n:k:e::l:e:|:ɛ:ŋ:k:ə::l:ə:	2
enne	:e:n:n:e:|:ɛ::n:ə:	7
enorm	:e::n:o:rm|:eː::n:ɔ:rm	9
enorme	:e::n:o:r:m:e:|:eː::n:ɔ:r:m:ə:	10
envelop	:e:n:v:e::l:o:p|:ɛ:n:v:ə::l:ɔ:p	6
er	:e:r|:ɛ:r	4214
eraan	:e:r::aa:n|:ɛ:r::aː:n	26
eraf	:e:r::a:f|:ɛ:r::ɑ:f	11
erbij	:e:r:b:ij:|:ɛ:r:b:ɛi:	65
erdoor	:e:r:d:oo:r|:ɛ:r:d:oː:r	7
erdoorheen	:e:r:d:oo:r:h:ee:n|:ɛ:r:d:oː:r:h:eː:n	2
erf	:e:rf|:ɛ:rf	4
erg	:e:rg|:ɛ:rç	313
ergens	:e:r:g:e:ns|:ɛ:r:ɣ:ə:ns	37
erger	:e:r:g:e:r|:ɛ:r:ɣ:ə:r	4
ergste	:e:rg:st:e:|:ɛ:rç:st:ə:	3
erheen	:e:r:h:ee:n|:ɛ:r:h:eː:n	12
erin	:e:r::i:n|:ɛ:r::ɪ:n	67
ermee	:e:r:m:ee:|:ɛ:r:m:eː:	36
erna	:e:r:n:a:|:ɛ:r:n:aː:	12
ernaar	:e:r:n:aa:r|:ɛ:r:n:aː:r	8
ernaast	:e:r:n:aa:st|:ɛ:r:n:aː:st	6
ernstig	:e:rn:st:i:g|:ɛ:rn:st:ə:ç	11
erom	:e:r::o:m|:ɛ:r::ɔ:m	10
eromheen	:e:r::o:m:h:ee:n|:ɛ:r::ɔ:m:h:eː:n	4
eronder	:e:r::o:n:d:e:r|:ɛ:r::ɔ:n:d:ə:r	5
erop	:e:r::o:p|:ɛ:r::ɔ:p	57
eropuit	:e:r::o:p::ui:t|:ɛ:r::ɔ:p::œy:t	2
erover	:e:r::o::v:e:r|:ɛ:r::oː::v:ə:r	3
ertegen	:e:r:t:e::g:e:n|:ɛ:r:t:eː::ɣ:ə:	2
eruit	:e:r::ui:t|:ɛ:r::œy:t	51
eruitziet	:e:r::ui:t:z:ie:t|:ɛ:r::œy:t:s:iː:t	4
ervan	:e:r:v:a:n|:ɛ:r:v:ɑ:n	55
ervandoor	:e:r:v:a:n:d:oo:r|:ɛ:r:v:ɑ:n:d:oː:r	11
ervoor	:e:r:v:oo:r|:ɛ:r:v:oː:r	10
erwt	:e:rwt|:ɛ:rt	2
es	:e:s|:ɛ:s	22
eskimo	:e:s:k:i::m:o:|:ɛ:s:k:iː::m:oː:	8
eten	:e::t:e:n|:eː::t:ə:	204
ets	:e:ts|:ɛ:ts	3
europa	:eu::r:o::p:a:|:øː::r:oː::p:aː:	2
eva	:e::v:a:|:eː::v:aː:	3
even	:e::v:e:n|:eː::v:ə:	362
eventjes	:e::v:e:n:tj:e:s|:eː::v:ə:n:tj:ə:s	2
expres	:e:x:pr:e:s|:ɛ:ks:pr:ɛ:s	3
extra	:e:x:tr:a:|:ɛ:k:str:aː:	2
ezel	:e::z:e:l|:eː::z:ə:l	51
f	f::|:ɛ:f	53
fabriek	f:a::br:ie:k|f:ɑ::br:iː:k	7
familie	f:a::m:i::l:ie:|f:aː::m:iː::l:iː:	7
fantastisch	f:a:n:t:a:s:t:i:sch|f:ɑ:n:t:ɑ:s:t:iː:s	6
fee	f:ee:|f:eː:	102
feest	f:ee:st|f:eː:st	248
feestelijk	f:ee:s:t:e::l:ij:k|f:eː:s:t:ə::l:ə:k	2
feesten	f:ee:s:t:e:n|f:eː:s:t:ə:	5
feestje	f:ee:st:j:e:|f:eː:st:j:ə:	33
feestmaal	f:ee:st:m:aa:l|f:eː:st:m:aː:l	5
feestneus	f:ee:st:n:eu:s|f:eː:st:n:øː:s	3
fel	f:e:l|f:ɛ:l	15
felle	f:e:l:l:e:|f:ɛ::l:ə:	2
fiets	f:ie:ts|f:iː:ts	179
fietsband	f:ie:ts:b:a:nd|f:iː:dz:b:ɑ:nt	3
fietsbel	f:ie:ts:b:e:l|f:iː:dz:b:ɛ:l	6
fietsen	f:ie:t:s:e:n|f:iː:t:s:ə:	31
fietspad	f:ie:ts:p:a:d|f:iː:ts:p:ɑ:t	4
fietst	f:ie:tst|f:iː:tst	16
fietste	f:ie:t:st:e:|f:iː:ts:t:ə:	3
fietstocht	f:ie:ts:t:o:cht|f:iː:ts:t:ɔ:çt	5
fijn	f:ij:n|f:ɛi:n	316
fijne	f:ij::n:e:|f:ɛi::n:ə:	9
fijner	f:ij::n:e:r|f:ɛi::n:ə:r	4
fijnst	f:ij:nst|f:ɛi:nst	4
fijnste	f:ij:n:st:e:|f:ɛi:n:st:ə:	3
fik	f:i:k|f:ɪ:k	2
film	f:i:lm|f:ɪ:lm	51
fin	f:i:n|f:ɪ:n	25
fladderen	fl:a:d:d:e::r:e:n|fl:ɑ::d:ə::r:ə:	3
fladdert	fl:a:d:d:e:rt|fl:ɑ::d:ə:rt	3
flap	fl:a:p|fl:ɑ:p	17
flappen	fl:a:p:p:e:n|fl:ɑ::p:ə:	4
flapt	fl:a:pt|fl:ɑ:pt	3
flats	fl:a:ts|fl:ɛ:ts	2
flauw	fl:au:w|fl:ɑu:w	13
fles	fl:e:s|fl:ɛ:s	55
flesje	fl:e:s:j:e:|fl:ɛ:s:j:ə:	10
flessen	fl:e:s:s:e:n|fl:ɛ::s:ə:	9
fleur	fl:eu:r|fl:øː:r	60
flink	fl:i:nk|fl:ɪ:ŋk	22
flinke	fl:i:n:k:e:|fl:ɪ:ŋ:k:ə:	7
flits	fl:i:ts|fl:ɪ:ts	12
flitst	fl:i:tst|fl:ɪ:tst	13
floep	fl:oe:p|fl:uː:p	7
floept	fl:oe:pt|fl:uː:pt	7
floot	fl:oo:t|fl:oː:t	2
flop	fl:o:p|fl:ɔ:p	3
fluisteren	fl:ui:s:t:e::r:e:n|fl:œy:s:t:ə::r:ə:	4
fluistert	fl:ui:s:t:e:rt|fl:œy:s:t:ə:rt	50
fluit	fl:ui:t|fl:œy:t	41
fluiten	fl:ui::t:e:n|fl:œy::t:ə:	4
foei	f:oe:i|f:uː:j	6
fornuis	f:o:r:n:ui:s|f:ɔ:r:n:œy:s	11
foto	f:o::t:o:|f:oː::t:oː:	81
fotoboek	f:o::t:o::b:oe:k|f:oː::t:oː::b:uː:k	35
fototoestel	f:o::t:o::t:oe::st:e:l|f:oː::t:oː::t:uː::st:ɛ:l	3
fout	f:ou:t|f:ɑu:t	44
fouten	f:ou::t:e:n|f:ɑu::t:ə:	5
fraai	fr:aa:i|fr:aː:j	4
frank	fr:a:nk|fr:ɑ:ŋk	66
frankrijk	fr:a:nk:r:ij:k|fr:ɑ:ŋk:r:ɛi:k	9
frans	fr:a:ns|fr:ɑ:ns	2
franse	fr:a:n:s:e:|fr:ɑ:n:s:ə:	3
friet	fr:ie:t|fr:iː:t	62
frietje	fr:ie:t:j:e:|fr:iː:t:j:ə:	2
frietjes	fr:ie:t:j:e:s|fr:iː:t:j:ə:s	10
fris	fr:i:s|fr:ɪ:s	22
frisdrank	fr:i:s:dr:a:nk|fr:ɪ:z:dr:ɑ:ŋk	5
frisse	fr:i:s:s:e:|fr:ɪ::s:ə:	4
frons	fr:o:ns|fr:ɔ:ns	3
fronst	fr:o:nst|fr:ɔ:nst	3
fruit	fr:ui:t|fr:œy:t	101
fruitschaal	fr:ui:t:sch:aa:l|fr:œy:t:sç:aː:l	3
fuut	f:uu:t|f:yː:t	3
g	g::|ç:eː:	48
ga	g:a:|ç:aː:	505
gaaf	g:aa:f|ç:aː:f	21
gaan	g:aa:n|ç:aː:n	1018
gaap	g:aa:p|ç:aː:p	7
gaapt	g:aa:pt|ç:aː:pt	36
gaar	g:aa:r|ç:aː:r	8
gaas	g:aa:s|ç:aː:s	12
gaat	g:aa:t|ç:aː:t	1508
gaatje	g:aa:t:j:e:|ç:ɑ:t:j:ə:	23
gaatjes	g:aa:t:j:e:s|ç:ɑ:t:j:ə:s	8
gaf	g:a:f|ç:ɑ:f	38
gak	g:a:k|ç:ɑ:k	9
galmt	g:a:lmt|ç:ɑ:lmt	2
gang	g:a:ng|ç:ɑ:ŋ	92
gangen	g:a:n:g:e:n|ç:ɑ::ŋ:ə:	9
gans	g:a:ns|ç:ɑ:ns	84
ganzen	g:a:n:z:e:n|ç:ɑ:n:z:ə:	11
gapen	g:a::p:e:n|ç:aː::p:ə:	4
garage	g:a::r:a::g:e:|ç:aː::r:aː::ʒ:ə:	3
garde	g:a:r:d:e:|ç:ɑ:r:d:ə:	3
garnaal	g:a:r:n:aa:l|ç:ɑ:r:n:aː:l	4
gas	g:a:s|ç:ɑ:s	14
gast	g:a:st|ç:ɑ:st	18
gasten	g:a:s:t:e:n|ç:ɑ:s:t:ə:	11
gasvlam	g:a:s:vl:a:m|ç:ɑ:s:fl:ɑ:m	5
gat	g:a:t|ç:ɑ:t	99
gaten	g:a::t:e:n|ç:aː::t:ə:	26
gauw	g:au:w|ç:ɑu:w	156
gave	g:a::v:e:|ç:aː::v:ə:	2
ge	g:e:|ç:ə:	58
gebak	g:e::b:a:k|ç:ə::b:ɑ:k	6
gebakken	g:e::b:a:k:k:e:n|ç:ə::b:ɑ::k:ə:	5
gebaren	g:e::b:a::r:e:n|ç:ə::b:aː::r:ə:	3
gebeld	g:e::b:e:ld|ç:ə::b:ɛ:lt	10
gebeurd	g:e::b:eu:rd|ç:ə::b:øː:rt	36
gebeurde	g:e::b:eu:r:d:e:|ç:ə::b:øː:r:d:ə:	10
gebeuren	g:e::b:eu::r:e:n|ç:ə::b:øː::r:ə:	27
gebeurt	g:e::b:eu:rt|ç:ə::b:øː:rt	65
gebleven	g:e::bl:e::v:e:n|ç:ə::bl:eː::v:ə:	10
gebogen	g:e::b:o::g:e:n|ç:ə::b:oː::ɣ:ə:	2
gebonk	g:e::b:o:nk|ç:ə::b:ɔ:ŋk	3
geboren	g:e::b:o::r:e:n|ç:ə::b:oː::r:ə:	8
gebouw	g:e::b:ou:w|ç:ə::b:ɑu:w	9
gebouwd	g:e::b:ou:wd|ç:ə::b:ɑu:wt	9
gebracht	g:e::br:a:cht|ç:ə::br:ɑ:çt	7
gebroken	g:e::br:o::k:e:n|ç:ə::br:oː::k:ə:	10
gebruik	g:e::br:ui:k|ç:ə::br:œy:k	6
gebruiken	g:e::br:ui::k:e:n|ç:ə::br:œy::k:ə:	9
gebruikt	g:e::br:ui:kt|ç:ə::br:œy:kt	9
gebrul	g:e::br:u:l|ç:ə::br:ʉ:l	2
gedaan	g:e::d:aa:n|ç:ə::d:aː:n	67
gedacht	g:e::d:a:cht|ç:ə::d:ɑ:çt	14
gedachte	g:e::d:a:ch:t:e:|ç:ə::d:ɑ:ç:t:ə:	2
gedachten	g:e::d:a:ch:t:e:n|ç:ə::d:ɑ:ç:t:ə:	4
gedekt	g:e::d:e:kt|ç:ə::d:ɛ:kt	2
gedicht	g:e::d:i:cht|ç:ə::d:ɪ:çt	8
gedoe	g:e::d:oe:|ç:ə::d:uː:	2
gedoucht	g:e::d:ou:cht|ç:ə::d:uː:ʃt	2
gedraag	g:e::dr:aa:g|ç:ə::dr:aː:ç	2
gedroogd	g:e::dr:oo:gd|ç:ə::dr:oː:çt	2
gedroomd	g:e::dr:oo:md|ç:ə::dr:oː:mt	5
geduld	g:e::d:u:ld|ç:ə::d:ʉ:lt	6
geduldig	g:e::d:u:l:d:i:g|ç:ə::d:ʉ:l:d:ə:ç	6
geef	g:ee:f|ç:eː:f	182
geeft	g:ee:ft|ç:eː:ft	403
geel	g:ee:l|ç:eː:l	55
geen	g:ee:n|ç:eː:n	1219
geert	g:ee:rt|ç:eː:rt	14
geertje	g:ee:r:tj:e:|ç:eː:r:tj:ə:	2
geest	g:ee:st|ç:eː:st	25
geeuw	g:ee:uw|ç:eː:w	9
geeuwt	g:ee:uwt|ç:eː:wt	7
gefeliciteerd	g:e::f:e::l:i::c:i::t:ee:rd|ç:ə::f:eː::l:iː::s:iː::t:eː:rt	3
gefopt	g:e::f:o:pt|ç:ə::f:ɔ:pt	2
gegaan	g:e::g:aa:n|ç:ə::ɣ:aː:n	20
gegeten	g:e::g:e::t:e:n|ç:ə::ɣ:eː::t:ə:	4
gegeven	g:e::g:e::v:e:n|ç:ə::ɣ:eː::v:ə:	3
gegil	g:e::g:i:l|ç:ə::ɣ:ɪ:l	3
gegooid	g:e::g:oo:id|ç:ə::ɣ:oː:jt	3
gegraven	g:e::gr:a::v:e:n|ç:ə::ɣr:aː::v:ə:	2
gehaald	g:e::h:aa:ld|ç:ə::h:aː:lt	6
gehad	g:e::h:a:d|ç:ə::h:ɑ:t	27
gehakt	g:e::h:a:kt|ç:ə::h:ɑ:kt	4
gehangen	g:e::h:a:n:g:e:n|ç:ə::h:ɑ::ŋ:ə:	2
geheim	g:e::h:ei:m|ç:ə::h:ɛi:m	50
geheimtaal	g:e::h:ei:m:t:aa:l|ç:ə::h:ɛi:m:t:aː:l	5
geheugen	g:e::h:eu::g:e:n|ç:ə::h:øː::ɣ:ə:	2
geholpen	g:e::h:o:l:p:e:n|ç:ə::h:ɔ:l:p:ə:	2
gehoord	g:e::h:oo:rd|ç:ə::h:oː:rt	22
gehouden	g:e::h:ou::d:e:n|ç:ə::h:ɑu::d:ə:	5
geit	g:ei:t|ç:ɛi:t	227
geiten	g:ei::t:e:n|ç:ɛi::t:ə:	4
gek	g:e:k|ç:ɛ:k	209
gekke	g:e:k:k:e:|ç:ɛ::k:ə:	27
gekker	g:e:k:k:e:r|ç:ɛ::k:ə:r	4
gekleurd	g:e::kl:eu:rd|ç:ə::kl:øː:rt	5
geklommen	g:e::kl:o:m:m:e:n|ç:ə::kl:ɔ::m:ə:	6
geklopt	g:e::kl:o:pt|ç:ə::kl:ɔ:pt	7
geknipt	g:e::kn:i:pt|ç:ə::kn:ɪ:pt	5
gekocht	g:e::k:o:cht|ç:ə::k:ɔ:çt	19
gekomen	g:e::k:o::m:e:n|ç:ə::k:oː::m:ə:	21
gekookt	g:e::k:oo:kt|ç:ə::k:oː:kt	8
gekregen	g:e::kr:e::g:e:n|ç:ə::kr:eː::ɣ:ə:	20
gekreukt	g:e::kr:eu:kt|ç:ə::kr:øː:kt	2
gekste	g:e:k:st:e:|ç:ɛ:k:st:ə:	4
gel	g:e:l|ç:ɛ:l	2
gel	g:e:l|ʒ:ɛ:l	2
geladen	g:e::l:a::d:e:n|ç:ə::l:aː::d:ə:	2
geld	g:e:ld|ç:ɛ:lt	110
gele	g:e::l:e:|ç:eː::l:ə:	36
geleden	g:e::l:e::d:e:n|ç:ə::l:eː::d:ə:	19
geleend	g:e::l:ee:nd|ç:ə::l:eː:nt	6
geleerd	g:e::l:ee:rd|ç:ə::l:eː:rt	9
geleerde	g:e::l:ee:r:d:e:|ç:ə::l:eː:r:d:ə:	5
gelegd	g:e::l:e:gd|ç:ə::l:ɛ:çt	4
gelezen	g:e::l:e::z:e:n|ç:ə::l:eː::z:ə:	4
gelijk	g:e::l:ij:k|ç:ə::l:ɛi:k	44
geloof	g:e::l:oo:f|ç:ə::l:oː:f	27
gelooft	g:e::l:oo:ft|ç:ə::l:oː:ft	26
gelopen	g:e::l:o::p:e:n|ç:ə::l:oː::p:ə:	5
geloven	g:e::l:o::v:e:n|ç:ə::l:oː::v:ə:	17
geluid	g:e::l:ui:d|ç:ə::l:œy:t	93
geluiden	g:e::l:ui::d:e:n|ç:ə::l:œy::d:ə:	9
geluisterd	g:e::l:ui:s:t:e:rd|ç:ə::l:œy:s:t:ə:rt	2
geluk	g:e::l:u:k|ç:ə::l:ʉ:k	29
gelukkig	g:e::l:u:k:k:i:g|ç:ə::l:ʉ::k:ə:ç	77
gelukt	g:e::l:u:kt|ç:ə::l:ʉ:kt	11
gemaakt	g:e::m:aa:kt|ç:ə::m:aː:kt	84
gemak	g:e::m:a:k|ç:ə::m:ɑ:k	4
gemakkelijk	g:e::m:a:k:k:e::l:ij:k|ç:ə::m:ɑ::k:ə::l:ə:k	5
gemeen	g:e::m:ee:n|ç:ə::m:eː:n	22
gemene	g:e::m:e::n:e:|ç:ə::m:eː::n:ə:	4
gemerkt	g:e::m:e:rkt|ç:ə::m:ɛ:rkt	3
gen	g:e:n|ç:ɛ:n	7
geniet	g:e::n:ie:t|ç:ə::n:iː:t	10
genoeg	g:e::n:oe:g|ç:ə::n:uː:ç	85
genoemd	g:e::n:oe:md|ç:ə::n:uː:mt	6
genomen	g:e::n:o::m:e:n|ç:eː::n:oː::m:ə:	4
genomen	g:e::n:o::m:e:n|ç:ə::n:oː::m:ə:	4
genot	g:e::n:o:t|ç:ə::n:ɔ:t	2
geoefend	g:e:::oe::f:e:nd|ç:ə:::uː::f:ə:nt	3
gepakt	g:e::p:a:kt|ç:ə::p:ɑ:kt	14
gepiep	g:e::p:ie:p|ç:ə::p:iː:p	3
geplakt	g:e::pl:a:kt|ç:ə::pl:ɑ:kt	12
geplant	g:e::pl:a:nt|ç:ə::pl:ɑ:nt	2
geplukt	g:e::pl:u:kt|ç:ə::pl:ʉ:kt	4
geprikt	g:e::pr:i:kt|ç:ə::pr:ɪ:kt	2
gered	g:e::r:e:d|ç:ə::r:ɛ:t	17
geritsel	g:e::r:i:t:s:e:l|ç:ə::r:ɪ:t:s:ə:l	2
geroepen	g:e::r:oe::p:e:n|ç:ə::r:uː::p:ə:	2
geroerd	g:e::r:oe:rd|ç:ə::r:uː:rt	2
gerust	g:e::r:u:st|ç:ə::r:ʉ:st	4
geschenken	g:e::sch:e:n:k:e:n|ç:ə::sç:ɛ:ŋ:k:ə:	2
geschreven	g:e::schr:e::v:e:n|ç:ə::sçr:eː::v:ə:	7
geschrokken	g:e::schr:o:k:k:e:n|ç:ə::sçr:ɔ::k:ə:	17
geslaagd	g:e::sl:aa:gd|ç:ə::sl:aː:çt	3
geslapen	g:e::sl:a::p:e:n|ç:ə::sl:aː::p:ə:	4
gesmolten	g:e::sm:o:l:t:e:n|ç:ə::sm:ɔ:l:t:ə:	2
gesneden	g:e::sn:e::d:e:n|ç:ə::sn:eː::d:ə:	3
gesp	g:e:sp|ç:ɛ:sp	4
gespeeld	g:e::sp:ee:ld|ç:ə::sp:eː:lt	7
gesprek	g:e::spr:e:k|ç:ə::spr:ɛ:k	4
gesproken	g:e::spr:o::k:e:n|ç:ə::spr:oː::k:ə:	3
gesprongen	g:e::spr:o:n:g:e:n|ç:ə::spr:ɔ::ŋ:ə:	3
gestolen	g:e::st:o::l:e:n|ç:ə::st:oː::l:ə:	3
gestopt	g:e::st:o:pt|ç:ə::st:ɔ:pt	9
gestuurd	g:e::st:uu:rd|ç:ə::st:yː:rt	2
getal	g:e::t:a:l|ç:ə::t:ɑ:l	4
getallen	g:e::t:a:l:l:e:n|ç:ə::t:ɑ::l:ə:	2
getekend	g:e::t:e::k:e:nd|ç:ə::t:eː::k:ə:nt	3
getrouwd	g:e::tr:ou:wd|ç:ə::tr:ɑu:wt	4
geur	g:eu:r|ç:øː:r	24
geuren	g:eu::r:e:n|ç:øː::r:ə:	4
gevaar	g:e::v:aa:r|ç:ə::v:aː:r	23
gevaarlijk	g:e::v:aa:r:l:ij:k|ç:ə::v:aː:r:l:ə:k	21
gevaarlijke	g:e::v:aa:r:l:ij::k:e:|ç:ə::v:aː:r:l:ə::k:ə:	10
geval	g:e::v:a:l|ç:ə::v:ɑ:l	10
gevallen	g:e::v:a:l:l:e:n|ç:ə::v:ɑ::l:ə:	19
gevangen	g:e::v:a:n:g:e:n|ç:ə::v:ɑ::ŋ:ə:	5
gevaren	g:e::v:a::r:e:n|ç:ə::v:aː::r:ə:	4
gevecht	g:e::v:e:cht|ç:ə::v:ɛ:çt	6
geven	g:e::v:e:n|ç:eː::v:ə:	57
geverfd	g:e::v:e:rfd|ç:ə::v:ɛ:rft	7
gevierd	g:e::v:ie:rd|ç:ə::v:iː:rt	2
gevlogen	g:e::vl:o::g:e:n|ç:ə::vl:oː::ɣ:ə:	2
gevoel	g:e::v:oe:l|ç:ə::v:uː:l	10
gevolgd	g:e::v:o:lgd|ç:ə::v:ɔ:lçt	2
gevonden	g:e::v:o:n:d:e:n|ç:ə::v:ɔ:n:d:ə:	23
gevraagd	g:e::vr:aa:gd|ç:ə::vr:aː:çt	6
gewacht	g:e::w:a:cht|ç:ə::w:ɑ:çt	6
gewassen	g:e::w:a:s:s:e:n|ç:ə::w:ɑ::s:ə:	2
geweer	g:e::w:ee:r|ç:ə::w:eː:r	5
geweest	g:e::w:ee:st|ç:ə::w:eː:st	82
geweldig	g:e::w:e:l:d:i:g|ç:ə::w:ɛ:l:d:ə:ç	20
gewend	g:e::w:e:nd|ç:ə::w:ɛ:nt	8
gewenst	g:e::w:e:nst|ç:ə::w:ɛ:nst	3
gewerkt	g:e::w:e:rkt|ç:ə::w:ɛ:rkt	8
gewicht	g:e::w:i:cht|ç:ə::w:ɪ:çt	9
gewond	g:e::w:o:nd|ç:ə::w:ɔ:nt	13
gewone	g:e::w:o::n:e:|ç:ə::w:oː::n:ə:	12
gewonnen	g:e::w:o:n:n:e:n|ç:ə::w:ɔ::n:ə:	13
gewoon	g:e::w:oo:n|ç:ə::w:oː:n	154
gewoond	g:e::w:oo:nd|ç:ə::w:oː:nt	5
geworden	g:e::w:o:r:d:e:n|ç:ə::w:ɔ:r:d:ə:	20
gezegd	g:e::z:e:gd|ç:ə::z:ɛ:çt	28
gezellig	g:e::z:e:l:l:i:g|ç:ə::z:ɛ::l:ə:ç	26
gezet	g:e::z:e:t|ç:ə::z:ɛ:t	10
gezeten	g:e::z:e::t:e:n|ç:ə::z:eː::t:ə:	4
gezeur	g:e::z:eu:r|ç:ə::z:øː:r	2
gezicht	g:e::z:i:cht|ç:ə::z:ɪ:çt	70
gezichten	g:e::z:i:ch:t:e:n|ç:ə::z:ɪ:ç:t:ə:	4
gezien	g:e::z:ie:n|ç:ə::z:iː:n	99
gezin	g:e::z:i:n|ç:ə::z:ɪ:n	15
gezocht	g:e::z:o:cht|ç:ə::z:ɔ:çt	8
gezond	g:e::z:o:nd|ç:ə::z:ɔ:nt	19
gezonde	g:e::z:o:n:d:e:|ç:ə::z:ɔ:n:d:ə:	3
gezonken	g:e::z:o:n:k:e:n|ç:ə::z:ɔ:ŋ:k:ə:	4
giechelt	g:ie::ch:e:lt|ç:iː::ç:ə:lt	11
gieren	g:ie::r:e:n|ç:iː::r:ə:	4
gierig	g:ie::r:i:g|ç:iː::r:ə:ç	5
giert	g:ie:rt|ç:iː:rt	13
giet	g:ie:t|ç:iː:t	30
gieten	g:ie::t:e:n|ç:iː::t:ə:	2
gieter	g:ie::t:e:r|ç:iː::t:ə:r	3
gif	g:i:f|ç:ɪ:f	9
gil	g:i:l|ç:ɪ:l	55
gillen	g:i:l:l:e:n|ç:ɪ::l:ə:	16
gilletje	g:i:l:l:e::tj:e:|ç:ɪ::l:ə::tj:ə:	2
gilt	g:i:lt|ç:ɪ:lt	164
gin	g:i:n|ʤ:ɪ:n	2
ginds	g:i:nds|ç:ɪ:nts	2
ging	g:i:ng|ç:ɪ:ŋ	162
gingen	g:i:n:g:e:n|ç:ɪ::ŋ:ə:	42
gips	g:i:ps|ç:ɪ:ps	6
giraf	g:i::r:a:f|ç:iː::r:ɑ:f	2
gist	g:i:st|ç:ɪ:st	11
gisteren	g:i:s:t:e::r:e:n|ç:ɪ:s:t:ə::r:ə:	16
gitaar	g:i::t:aa:r|ç:iː::t:aː:r	9
glaasje	gl:aa:s:j:e:|çl:aː:s:j:ə:	5
glad	gl:a:d|çl:ɑ:t	19
gladde	gl:a:d:d:e:|çl:ɑ::d:ə:	4
gladste	gl:a:d:st:e:|çl:ɑ:t:st:ə:	2
glans	gl:a:ns|çl:ɑ:ns	9
glanst	gl:a:nst|çl:ɑ:nst	6
glanzen	gl:a:n:z:e:n|çl:ɑ:n:z:ə:	3
glas	gl:a:s|çl:ɑ:s	61
glazen	gl:a::z:e:n|çl:aː::z:ə:	14
gleed	gl:ee:d|çl:eː:t	3
gleuf	gl:eu:f|çl:øː:f	7
glibbert	gl:i:b:b:e:rt|çl:ɪ::b:ə:rt	4
glijbaan	gl:ij::b:aa:n|çl:ɛi::b:aː:n	10
glijbanen	gl:ij::b:a::n:e:n|çl:ɛi::b:aː::n:ə:	4
glijden	gl:ij::d:e:n|çl:ɛi::d:ə:	16
glijdt	gl:ij:dt|çl:ɛi:t	24
glim	gl:i:m|çl:ɪ:m	3
glimlach	gl:i:m:l:a:ch|çl:ɪ:m:l:ɑ:ç	3
glimlachend	gl:i:m:l:a::ch:e:nd|çl:ɪ:m:l:ɑ::ç:ə:nt	3
glimlacht	gl:i:m:l:a:cht|çl:ɪ:m:l:ɑ:çt	32
glimmen	gl:i:m:m:e:n|çl:ɪ::m:ə:	4
glimmende	gl:i:m:m:e:n:d:e:|çl:ɪ::m:ə:n:d:ə:	2
glimt	gl:i:mt|çl:ɪ:mt	25
glinsteren	gl:i:n:st:e::r:e:n|çl:ɪ:n:st:ə::r:ə:	3
glinstert	gl:i:n:st:e:rt|çl:ɪ:n:st:ə:rt	4
glippen	gl:i:p:p:e:n|çl:ɪ::p:ə:	2
glipt	gl:i:pt|çl:ɪ:pt	3
glitters	gl:i:t:t:e:rs|çl:ɪ::t:ə:rs	4
globe	gl:o::b:e:|çl:oː::b:ə:	4
gloeien	gl:oe:i::e:n|çl:uː::j:ə:	2
gloeiend	gl:oe:i::e:nd|çl:uː::j:ə:nt	2
glundert	gl:u:n:d:e:rt|çl:ʉ:n:d:ə:rt	5
gluren	gl:u::r:e:n|çl:yː::r:ə:	9
gluur	gl:uu:r|çl:yː:r	4
gluurt	gl:uu:rt|çl:yː:rt	15
god	g:o:d|ç:ɔ:t	6
goed	g:oe:d|ç:uː:t	1092
goede	g:oe::d:e:|ç:uː::d:ə:	77
goedkoop	g:oe:d:k:oo:p|ç:uː:t:k:oː:p	2
goeie	g:oe:i::e:|ç:uː::j:ə:	11
gok	g:o:k|ç:ɔ:k	2
gokt	g:o:kt|ç:ɔ:kt	2
golf	g:o:lf|ç:ɔ:lf	19
golven	g:o:l:v:e:n|ç:ɔ:l:v:ə:	33
gong	g:o:ng|ç:ɔ:ŋ	10
goochelaar	g:oo::ch:e::l:aa:r|ç:oː::ç:ə::l:aː:r	3
gooi	g:oo:i|ç:oː:j	25
gooide	g:oo:i:d:e:|ç:oː:j:d:ə:	6
gooiden	g:oo:i:d:e:n|ç:oː:j:d:ə:	4
gooien	g:oo:i::e:n|ç:oː::j:ə:	31
gooit	g:oo:it|ç:oː:jt	106
goot	g:oo:t|ç:oː:t	11
gordels	g:o:r:d:e:ls|ç:ɔ:r:d:ə:ls	3
gordijn	g:o:r:d:ij:n|ç:ɔ:r:d:ɛi:n	18
gordijnen	g:o:r:d:ij::n:e:n|ç:ɔ:r:d:ɛi::n:ə:	14
gort	g:o:rt|ç:ɔ:rt	5
goud	g:ou:d|ç:ɑu:t	88
gouden	g:ou::d:e:n|ç:ɑu::d:ə:	34
goudstukken	g:ou:d:st:u:k:k:e:n|ç:ɑu:t:st:ʉ::k:ə:	3
graaf	gr:aa:f|çr:aː:f	6
graaft	gr:aa:ft|çr:aː:ft	27
graag	gr:aa:g|çr:aː:ç	255
graaien	gr:aa:i::e:n|çr:aː::j:ə:	3
graait	gr:aa:it|çr:aː:jt	13
graan	gr:aa:n|çr:aː:n	16
graast	gr:aa:st|çr:aː:st	5
graat	gr:aa:t|çr:aː:t	38
gracht	gr:a:cht|çr:ɑ:çt	11
graden	gr:a::d:e:n|çr:aː::d:ə:	2
gram	gr:a:m|çr:ɑ:m	14
grap	gr:a:p|çr:ɑ:p	26
grapjas	gr:a:p:j:a:s|çr:ɑ:p:j:ɑ:s	8
grapje	gr:a:p:j:e:|çr:ɑ:p:j:ə:	11
grapjes	gr:a:p:j:e:s|çr:ɑ:p:j:ə:s	9
grappig	gr:a:p:p:i:g|çr:ɑ::p:ə:ç	34
grappige	gr:a:p:p:i::g:e:|çr:ɑ::p:ə::ɣ:ə:	3
gras	gr:a:s|çr:ɑ:s	114
grasveld	gr:a:s:v:e:ld|çr:ɑ:s:f:ɛ:lt	3
graten	gr:a::t:e:n|çr:aː::t:ə:	2
gratis	gr:a::t:i:s|çr:aː::t:ə:s	6
grauw	gr:au:w|çr:ɑu:w	2
grauwe	gr:au::w:e:|çr:ɑu::w:ə:	3
graven	gr:a::v:e:n|çr:aː::v:ə:	24
grazen	gr:a::z:e:n|çr:aː::z:ə:	6
greep	gr:ee:p|çr:eː:p	4
grens	gr:e:ns|çr:ɛ:ns	2
griep	gr:ie:p|çr:iː:p	4
griet	gr:ie:t|çr:iː:t	23
grietje	gr:ie:t:j:e:|çr:iː:t:j:ə:	10
griezel	gr:ie::z:e:l|çr:iː::z:ə:l	2
griezelen	gr:ie::z:e::l:e:n|çr:iː::z:ə::l:ə:	3
griezelt	gr:ie::z:e:lt|çr:iː::z:ə:lt	3
grijns	gr:ij:ns|çr:ɛi:ns	3
grijnst	gr:ij:nst|çr:ɛi:nst	8
grijp	gr:ij:p|çr:ɛi:p	4
grijpen	gr:ij::p:e:n|çr:ɛi::p:ə:	3
grijpt	gr:ij:pt|çr:ɛi:pt	22
grijs	gr:ij:s|çr:ɛi:s	40
grijze	gr:ij::z:e:|çr:ɛi::z:ə:	11
gril	gr:i:l|çr:ɪ:l	38
grinnikt	gr:i:n:n:i:kt|çr:ɪ::n:ə:kt	18
grist	gr:i:st|çr:ɪ:st	4
groei	gr:oe:i|çr:uː:j	7
groeide	gr:oe:i:d:e:|çr:uː:j:d:ə:	2
groeiden	gr:oe:i:d:e:n|çr:uː:j:d:ə:	2
groeien	gr:oe:i::e:n|çr:uː::j:ə:	16
groeit	gr:oe:it|çr:uː:jt	30
groen	gr:oe:n|çr:uː:n	82
groene	gr:oe::n:e:|çr:uː::n:ə:	40
groener	gr:oe::n:e:r|çr:uː::n:ə:r	2
groente	gr:oe:n:t:e:|çr:uː:n:t:ə:	4
groenteman	gr:oe:n:t:e::m:a:n|çr:uː:n:t:ə::m:ɑ:n	7
groep	gr:oe:p|çr:uː:p	66
groepje	gr:oe:p:j:e:|çr:uː:p:j:ə:	6
groet	gr:oe:t|çr:uː:t	11
groeten	gr:oe::t:e:n|çr:uː::t:ə:	10
groetjes	gr:oe:t:j:e:s|çr:uː:t:j:ə:s	4
grom	gr:o:m|çr:ɔ:m	4
grommen	gr:o:m:m:e:n|çr:ɔ::m:ə:	6
gromt	gr:o:mt|çr:ɔ:mt	23
grond	gr:o:nd|çr:ɔ:nt	179
groot	gr:oo:t|çr:oː:t	328
groots	gr:oo:ts|çr:oː:ts	5
grootst	gr:oo:tst|çr:oː:tst	3
grootste	gr:oo:t:st:e:|çr:oː:t:st:ə:	14
grootste	gr:oo:t:st:e:|çr:oː:ts:t:ə:	14
grot	gr:o:t|çr:ɔ:t	19
grote	gr:o::t:e:|çr:oː::t:ə:	322
groter	gr:o::t:e:r|çr:oː::t:ə:r	41
gum	g:u:m|ç:ʉ:m	9
guur	g:uu:r|ç:yː:r	5
gym	g:y:m|ç:ɪ:m	7
h	h::|h:aː:	289
ha	h:a:|h:aː:	90
haag	h:aa:g|h:aː:ç	7
haai	h:aa:i|h:aː:j	34
haaien	h:aa:i::e:n|h:aː::j:ə:	3
haak	h:aa:k|h:aː:k	51
haakje	h:aa:k:j:e:|h:aː:k:j:ə:	8
haakjes	h:aa:k:j:e:s|h:aː:k:j:ə:s	3
haakt	h:aa:kt|h:aː:kt	4
haal	h:aa:l|h:aː:l	73
haalde	h:aa:l:d:e:|h:aː:l:d:ə:	11
haalt	h:aa:lt|h:aː:lt	167
haan	h:aa:n|h:aː:n	63
haantje	h:aa:n:tj:e:|h:aː:n:tj:ə:	2
haar	h:aa:r|h:aː:r	2136
haard	h:aa:rd|h:aː:rt	16
haardos	h:aa:r:d:o:s|h:aː:r:d:ɔ:s	3
haartje	h:aa:r:tj:e:|h:aː:r:tj:ə:	3
haartjes	h:aa:r:tj:e:s|h:aː:r:tj:ə:s	10
haas	h:aa:s|h:aː:s	203
haast	h:aa:st|h:aː:st	105
haasten	h:aa:s:t:e:n|h:aː:s:t:ə:	2
haastig	h:aa:s:t:i:g|h:aː:s:t:ə:ç	5
haat	h:aa:t|h:aː:t	7
had	h:a:d|h:ɑ:t	245
hadden	h:a:d:d:e:n|h:ɑ::d:ə:	31
hagel	h:a::g:e:l|h:aː::ɣ:ə:l	3
hagelslag	h:a::g:e:l:sl:a:g|h:aː::ɣ:ə:l:sl:ɑ:ç	6
haha	h:a::h:a:|h:aː::h:aː:	7
hak	h:a:k|h:ɑ:k	33
haken	h:a::k:e:n|h:aː::k:ə:	3
hakken	h:a:k:k:e:n|h:ɑ::k:ə:	17
hakt	h:a:kt|h:ɑ:kt	28
hal	h:a:l|h:ɑ:l	29
halen	h:a::l:e:n|h:aː::l:ə:	68
half	h:a:lf|h:ɑ:lf	49
halfuur	h:a:lf::uu:r|h:ɑ:lf::yː:r	3
halfvol	h:a:lf:v:o:l|h:ɑ:l:f:ɔ:l	2
hallo	h:a:l:l:o:|h:ɑ::l:oː:	41
hals	h:a:ls|h:ɑ:ls	17
halt	h:a:lt|h:ɑ:lt	2
halte	h:a:l:t:e:|h:ɑ:l:t:ə:	3
halve	h:a:l:v:e:|h:ɑ:l:v:ə:	20
ham	h:a:m|h:ɑ:m	15
hamer	h:a::m:e:r|h:aː::m:ə:r	16
hamers	h:a::m:e:rs|h:aː::m:ə:rs	2
hamster	h:a:m:st:e:r|h:ɑ:m:st:ə:r	10
hamsters	h:a:m:st:e:rs|h:ɑ:m:st:ə:rs	2
hand	h:a:nd|h:ɑ:nt	249
handbal	h:a:nd:b:a:l|h:ɑ:nd:b:ɑ:l	2
handboei	h:a:nd:b:oe:i|h:ɑ:nd:b:uː:j	2
handdoek	h:a:nd:d:oe:k|h:ɑ:n:d:uː:k	8
handdoeken	h:a:nd:d:oe::k:e:n|h:ɑ:n:d:uː::k:ə:	2
handelen	h:a:n:d:e::l:e:n|h:ɑ:n:d:ə::l:ə:	2
handen	h:a:n:d:e:n|h:ɑ:n:d:ə:	100
handig	h:a:n:d:i:g|h:ɑ:n:d:ə:ç	26
handje	h:a:nd:j:e:|h:ɑ:nt:j:ə:	3
handschoen	h:a:nd:sch:oe:n|h:ɑ:nt:sç:uː:n	3
handvat	h:a:nd:v:a:t|h:ɑ:nt:f:ɑ:t	3
hanen	h:a::n:e:n|h:aː::n:ə:	6
hang	h:a:ng|h:ɑ:ŋ	24
hangen	h:a:n:g:e:n|h:ɑ::ŋ:ə:	28
hangmat	h:a:ng:m:a:t|h:ɑ:ŋ:m:ɑ:t	5
hangt	h:a:ngt|h:ɑ:ŋt	113
hans	h:a:ns|h:ɑ:ns	65
hap	h:a:p|h:ɑ:p	113
hapje	h:a:p:j:e:|h:ɑ:p:j:ə:	19
hapjes	h:a:p:j:e:s|h:ɑ:p:j:ə:s	6
hapt	h:a:pt|h:ɑ:pt	17
hard	h:a:rd|h:ɑ:rt	231
harde	h:a:r:d:e:|h:ɑ:r:d:ə:	21
harder	h:a:r:d:e:r|h:ɑ:r:d:ə:r	38
hardlopen	h:a:rd:l:o::p:e:n|h:ɑ:rd:l:oː::p:ə:	2
hardop	h:a:rd::o:p|h:ɑ:rd::ɔ:p	15
hardst	h:a:rdst|h:ɑ:rtst	2
haren	h:a::r:e:n|h:aː::r:ə:	44
harige	h:a::r:i::g:e:|h:aː::r:ə::ɣ:ə:	4
haring	h:a::r:i:ng|h:aː::r:ɪ:ŋ	4
hark	h:a:rk|h:ɑ:rk	16
harken	h:a:r:k:e:n|h:ɑ:r:k:ə:	4
harkt	h:a:rkt|h:ɑ:rkt	6
harnas	h:a:r:n:a:s|h:ɑ:r:n:ɑ:s	10
hart	h:a:rt|h:ɑ:rt	44
hartje	h:a:rt:j:e:|h:ɑ:rt:j:ə:	6
hartjes	h:a:rt:j:e:s|h:ɑ:rt:j:ə:s	3
hartstikke	h:a:rt:st:i:k:k:e:|h:ɑ:rt:st:ɪ::k:ə:	3
haven	h:a::v:e:n|h:aː::v:ə:	8
haver	h:a::v:e:r|h:aː::v:ə:r	2
he	h:e:|h:eː:	10
heb	h:e:b|h:ɛ:p	857
hebben	h:e:b:b:e:n|h:ɛ::b:ə:	358
hebbes	h:e:b:b:e:s|h:ɛ::b:ə:s	6
hebt	h:e:bt|h:ɛ:pt	153
hee	h:ee:|h:eː:	68
heeft	h:ee:ft|h:eː:ft	1326
heel	h:ee:l|h:eː:l	1236
heen	h:ee:n|h:eː:n	322
heer	h:ee:r|h:eː:r	28
heerlijk	h:ee:r:l:ij:k|h:eː:r:l:ə:k	44
heerlijke	h:ee:r:l:ij::k:e:|h:eː:r:l:ə::k:ə:	10
hees	h:ee:s|h:eː:s	8
heet	h:ee:t|h:eː:t	327
heetst	h:ee:tst|h:eː:tst	2
heette	h:ee:t:t:e:|h:eː::t:ə:	8
heft	h:e:ft|h:ɛ:ft	5
heg	h:e:g|h:ɛ:ç	47
heggen	h:e:g:g:e:n|h:ɛ::ɣ:ə:	4
hei	h:ei:|h:ɛi:	6
heimwee	h:ei:m:w:ee:|h:ɛi:m:w:eː:	2
hein	h:ei:n|h:ɛi:n	44
hek	h:e:k|h:ɛ:k	168
hekel	h:e::k:e:l|h:eː::k:ə:l	10
heks	h:e:ks|h:ɛ:ks	82
heksen	h:e:k:s:e:n|h:ɛ:k:s:ə:	7
helaas	h:e::l:aa:s|h:eː::l:aː:s	5
held	h:e:ld|h:ɛ:lt	20
helder	h:e:l:d:e:r|h:ɛ:l:d:ə:r	7
hele	h:e::l:e:|h:eː::l:ə:	176
heleboel	h:e::l:e::b:oe:l|h:eː::l:ə::b:uː:l	22
helemaal	h:e::l:e::m:aa:l|h:eː::l:ə::m:aː:l	134
helen	h:e::l:e:n|h:eː::l:ə:	3
helft	h:e:lft|h:ɛ:lft	16
helikopter	h:e::l:i::k:o:p:t:e:r|h:eː::l:iː::k:ɔ:p:t:ə:r	7
helling	h:e:l:l:i:ng|h:ɛ::l:ɪ:ŋ	2
helm	h:e:lm|h:ɛ:lm	45
help	h:e:lp|h:ɛ:lp	145
helpen	h:e:l:p:e:n|h:ɛ:l:p:ə:	81
helpt	h:e:lpt|h:ɛ:lpt	49
hem	h:e:m|h:ɛ:m	1109
hemd	h:e:md|h:ɛ:mt	20
hemden	h:e:m:d:e:n|h:ɛ:m:d:ə:	2
hemel	h:e::m:e:l|h:eː::m:ə:l	8
hen	h:e:n|h:ɛ:n	90
hengel	h:e:n:g:e:l|h:ɛ::ŋ:ə:l	6
hengeltje	h:e:n:g:e:l:tj:e:|h:ɛ::ŋ:ə:l:tj:ə:	7
herberg	h:e:r:b:e:rg|h:ɛ:r:b:ɛ:rç	10
herder	h:e:r:d:e:r|h:ɛ:r:d:ə:r	3
heren	h:e::r:e:n|h:eː::r:ə:	2
herfst	h:e:rfst|h:ɛ:rfst	23
herhaalt	h:e:r:h:aa:lt|h:ɛ:r:h:aː:lt	3
herken	h:e:r:k:e:n|h:ɛ:r:k:ɛ:n	7
herkent	h:e:r:k:e:nt|h:ɛ:r:k:ɛ:nt	7
herrie	h:e:r:r:ie:|h:ɛ::r:iː:	10
hersens	h:e:r:s:e:ns|h:ɛ:r:s:ə:ns	4
hert	h:e:rt|h:ɛ:rt	34
herten	h:e:r:t:e:n|h:ɛ:r:t:ə:	3
het	h:e:t|:ə:t	11383
hete	h:e::t:e:|h:eː::t:ə:	5
heten	h:e::t:e:n|h:eː::t:ə:	16
hetzelfde	h:e:t:z:e:lf:d:e:|h:ɛ:t:s:ɛ:lv:d:ə:	14
heup	h:eu:p|h:øː:p	4
heus	h:eu:s|h:øː:s	63
heuvel	h:eu::v:e:l|h:øː::v:ə:l	14
hiel	h:ie:l|h:iː:l	3
hield	h:ie:ld|h:iː:lt	26
hielden	h:ie:l:d:e:n|h:iː:l:d:ə:	2
hielp	h:ie:lp|h:iː:lp	8
hiep	h:ie:p|h:iː:p	22
hier	h:ie:r|h:iː:r	954
hierbij	h:ie:r:b:ij:|h:iː:r:b:ɛi:	3
hierboven	h:ie:r:b:o::v:e:n|h:iː:r:b:oː::v:ə:	3
hierheen	h:ie:r:h:ee:n|h:iː:r:h:eː:n	4
hiermee	h:ie:r:m:ee:|h:iː:r:m:eː:	2
hiernaast	h:ie:r:n:aa:st|h:iː:r:n:aː:st	3
hieronder	h:ie:r::o:n:d:e:r|h:iː:r::ɔ:n:d:ə:r	2
hiervan	h:ie:r:v:a:n|h:iː:r:v:ɑ:n	3
hij	h:ij:|h:ɛi:	6902
hijg	h:ij:g|h:ɛi:ç	3
hijgen	h:ij::g:e:n|h:ɛi::ɣ:ə:	3
hijgend	h:ij::g:e:nd|h:ɛi::ɣ:ə:nt	8
hijgt	h:ij:gt|h:ɛi:çt	28
hijs	h:ij:s|h:ɛi:s	18
hijskraan	h:ij:s:kr:aa:n|h:ɛi:s:kr:aː:n	7
hijst	h:ij:st|h:ɛi:st	8
hik	h:i:k|h:ɪ:k	8
hikt	h:i:kt|h:ɪ:kt	4
hing	h:i:ng|h:ɪ:ŋ	13
hingen	h:i:n:g:e:n|h:ɪ::ŋ:ə:	2
hink	h:i:nk|h:ɪ:ŋk	9
hinkelen	h:i:n:k:e::l:e:n|h:ɪ:ŋ:k:ə::l:ə:	3
hinkt	h:i:nkt|h:ɪ:ŋkt	4
hinnikt	h:i:n:n:i:kt|h:ɪ::n:ə:kt	3
hip	h:i:p|h:ɪ:p	7
hipt	h:i:pt|h:ɪ:pt	12
hitte	h:i:t:t:e:|h:ɪ::t:ə:	5
ho	h:o:|h:oː:	48
hobbel	h:o:b:b:e:l|h:ɔ::b:ə:l	4
hobbelpaard	h:o:b:b:e:l:p:aa:rd|h:ɔ::b:ə:l:p:aː:rt	3
hobbels	h:o:b:b:e:ls|h:ɔ::b:ə:ls	3
hobby	h:o:b:b:y:|h:ɔ::b:iː:	4
hoe	h:oe:|h:uː:	760
hoed	h:oe:d|h:uː:t	104
hoede	h:oe::d:e:|h:uː::d:ə:	2
hoedje	h:oe:d:j:e:|h:uː:t:j:ə:	15
hoedjes	h:oe:d:j:e:s|h:uː:t:j:ə:s	2
hoef	h:oe:f|h:uː:f	55
hoefde	h:oe:f:d:e:|h:uː:v:d:ə:	2
hoeft	h:oe:ft|h:uː:ft	80
hoek	h:oe:k|h:uː:k	108
hoeken	h:oe::k:e:n|h:uː::k:ə:	10
hoekje	h:oe:k:j:e:|h:uː:k:j:ə:	21
hoelang	h:oe::l:a:ng|h:uː::l:ɑ:ŋ	8
hoep	h:oe:p|h:uː:p	7
hoepel	h:oe::p:e:l|h:uː::p:ə:l	18
hoera	h:oe::r:a:|h:uː::r:aː:	29
hoest	h:oe:st|h:uː:st	8
hoeveel	h:oe::v:ee:l|h:uː::v:eː:l	17
hoeven	h:oe::v:e:n|h:uː::v:ə:	14
hoezo	h:oe::z:o:|h:uː::z:oː:	7
hoge	h:o::g:e:|h:oː::ɣ:ə:	50
hoger	h:o::g:e:r|h:oː::ɣ:ə:r	24
hoi	h:o:i|h:ɔ:j	39
hok	h:o:k|h:ɔ:k	186
hokje	h:o:k:j:e:|h:ɔ:k:j:ə:	4
hokjes	h:o:k:j:e:s|h:ɔ:k:j:ə:s	4
hokken	h:o:k:k:e:n|h:ɔ::k:ə:	2
hol	h:o:l|h:ɔ:l	52
holde	h:o:l:d:e:|h:ɔ:l:d:ə:	2
holle	h:o:l:l:e:|h:ɔ::l:ə:	3
hollen	h:o:l:l:e:n|h:ɔ::l:ə:	28
holletje	h:o:l:l:e::tj:e:|h:ɔ::l:ə::tj:ə:	9
holt	h:o:lt|h:ɔ:lt	116
hommel	h:o:m:m:e:l|h:ɔ::m:ə:l	2
homp	h:o:mp|h:ɔ:mp	2
hond	h:o:nd|h:ɔ:nt	343
honden	h:o:n:d:e:n|h:ɔ:n:d:ə:	46
honderd	h:o:n:d:e:rd|h:ɔ:n:d:ə:rt	23
hondje	h:o:nd:j:e:|h:ɔ:nt:j:ə:	46
honger	h:o:n:g:e:r|h:ɔ::ŋ:ə:r	22
honing	h:o::n:i:ng|h:oː::n:ɪ:ŋ	17
honk	h:o:nk|h:ɔ:ŋk	3
hoofd	h:oo:fd|h:oː:ft	270
hoofden	h:oo:f:d:e:n|h:oː:v:d:ə:	2
hoofdprijs	h:oo:fd:pr:ij:s|h:oː:ft:pr:ɛi:s	11
hoofdrol	h:oo:fd:r:o:l|h:oː:vd:r:ɔ:l	3
hoog	h:oo:g|h:oː:ç	184
hoogst	h:oo:gst|h:oː:çst	11
hoogste	h:oo:g:st:e:|h:oː:ç:st:ə:	12
hoogte	h:oo:g:t:e:|h:oː:ç:t:ə:	3
hoogtevrees	h:oo:g:t:e::vr:ee:s|h:oː:ç:t:ə::vr:eː:s	3
hooguit	h:oo:g::ui:t|h:oː:ç::œy:t	2
hooi	h:oo:i|h:oː:j	19
hooiberg	h:oo:i:b:e:rg|h:oː:j:b:ɛ:rç	6
hoop	h:oo:p|h:oː:p	52
hoopt	h:oo:pt|h:oː:pt	14
hoopte	h:oo:p:t:e:|h:oː:p:t:ə:	2
hoopvol	h:oo:p:v:o:l|h:oː:p:f:ɔ:l	3
hoor	h:oo:r|h:oː:r	504
hoorde	h:oo:r:d:e:|h:oː:r:d:ə:	25
hoorn	h:oo:rn|h:oː:rn	18
hoorntjes	h:oo:rn:tj:e:s|h:oː:rn:tj:ə:s	3
hoort	h:oo:rt|h:oː:rt	446
hop	h:o:p|h:ɔ:p	42
hopelijk	h:o::p:e::l:ij:k|h:oː::p:ə::l:ə:k	2
hopen	h:o::p:e:n|h:oː::p:ə:	5
hopjesvla	h:o:p:j:e:s:vl:a:|h:ɔ:p:j:ə:s:fl:aː:	3
hopt	h:o:pt|h:ɔ:pt	4
hor	h:o:r|h:ɔ:r	2
horen	h:o::r:e:n|h:oː::r:ə:	119
horizon	h:o::r:i::z:o:n|h:oː::r:iː::z:ɔ:n	3
horloge	h:o:r:l:o::g:e:|h:ɔ:r:l:oː::ʒ:ə:	22
horsten	h:o:r:st:e:n|h:ɔ:rs:t:ə:	2
hotel	h:o::t:e:l|h:oː::t:ɛ:l	7
hou	h:ou:|h:ɑu:	133
houd	h:ou:d|h:ɑu:t	62
houden	h:ou::d:e:n|h:ɑu::d:ə:	54
houder	h:ou::d:e:r|h:ɑu::d:ə:r	4
houdt	h:ou:dt|h:ɑu:t	212
hout	h:ou:t|h:ɑu:t	142
houten	h:ou::t:e:n|h:ɑu::t:ə:	9
hu	h:u:|h:yː:	146
huid	h:ui:d|h:œy:t	23
huifkar	h:ui:f:k:a:r|h:œy:f:k:ɑ:r	4
huil	h:ui:l|h:œy:l	11
huilen	h:ui::l:e:n|h:œy::l:ə:	69
huilend	h:ui::l:e:nd|h:œy::l:ə:nt	5
huilt	h:ui:lt|h:œy:lt	104
huis	h:ui:s|h:œy:s	988
huisdier	h:ui:s:d:ie:r|h:œy:z:d:iː:r	14
huisje	h:ui:s:j:e:|h:œy:s:j:ə:	36
huisjes	h:ui:s:j:e:s|h:œy:s:j:ə:s	2
huiskamer	h:ui:s:k:a::m:e:r|h:œy:s:k:aː::m:ə:r	3
huiswerk	h:ui:s:w:e:rk|h:œy:s:w:ɛ:rk	3
huizen	h:ui::z:e:n|h:œy::z:ə:	28
hulp	h:u:lp|h:ʉ:lp	22
humt	h:u:mt|h:ʉ:mt	3
hun	h:u:n|h:ʉ:n	321
hup	h:u:p|h:ʉ:p	97
huppel	h:u:p:p:e:l|h:ʉ::p:ə:l	2
huppelen	h:u:p:p:e::l:e:n|h:ʉ::p:ə::l:ə:	8
huppelt	h:u:p:p:e:lt|h:ʉ::p:ə:lt	14
hupt	h:u:pt|h:ʉ:pt	9
huren	h:u::r:e:n|h:yː::r:ə:	7
hurk	h:u:rk|h:ʉ:rk	3
hurkt	h:u:rkt|h:ʉ:rkt	6
hut	h:u:t|h:ʉ:t	225
huur	h:uu:r|h:yː:r	7
hè	h:è:|h:ɛ:	136
i	:i:|:iː:	1504
ia	:i:::a:|:iː:::aː:	20
idee	:i::d:ee:|:iː::d:eː:	100
ie	:ie:|:iː:	206
ieder	:ie::d:e:r|:iː::d:ə:r	30
iedere	:ie::d:e::r:e:|:iː::d:ə::r:ə:	11
iedereen	:ie::d:e:r::ee:n|:iː::d:ə:r::eː:n	112
iemand	:ie::m:a:nd|:iː::m:ɑ:nt	134
iep	:ie:p|:iː:p	14
ier	:ie:r|:iː:r	72
iet	:ie:t|:iː:t	257
iets	:ie:ts|:iː:ts	669
iglo	:i::gl:o:|:iː::ɣl:oː:	8
ij	:ij:|:ɛi:	5
ijs	:ij:s|:ɛi:s	243
ijsbaan	:ij:s:b:aa:n|:ɛi:z:b:aː:n	3
ijsbeer	:ij:s:b:ee:r|:ɛi:z:b:eː:r	13
ijsbergen	:ij:s:b:e:r:g:e:n|:ɛi:z:b:ɛ:r:ɣ:ə:	2
ijsje	:ij:s:j:e:|:ɛi:s:j:ə:	22
ijsjes	:ij:s:j:e:s|:ɛi:s:j:ə:s	12
ijskar	:ij:s:k:a:r|:ɛi:s:k:ɑ:r	11
ijskast	:ij:s:k:a:st|:ɛi:s:k:ɑ:st	2
ijskoud	:ij:s:k:ou:d|:ɛi:s:k:ɑu:t	4
ijskoude	:ij:s:k:ou::d:e:|:ɛi:s:k:ɑu::d:ə:	3
ijspegels	:ij:s:p:e::g:e:ls|:ɛi:s:p:eː::ɣ:ə:ls	2
ijssalon	:ij:s:s:a::l:o:n|:ɛi::s:aː::l:ɔ:n	4
ijsschotsen	:ij:s:sch:o:t:s:e:n|:ɛi::sç:ɔ:t:s:ə:	2
ijzer	:ij::z:e:r|:ɛi::z:ə:r	20
ijzeren	:ij::z:e::r:e:n|:ɛi::z:ə::r:ə:	7
ik	:i:k|:ɪ:k	10154
ikke	:i:k:k:e:|:ɪ::k:ə:	6
iks	:i:ks|:ɪ:ks	4
illustrator	:i:l:l:u::str:a::t:o:r|:ɪ::l:yː::str:aː::t:ɔ:r	7
immers	:i:m:m:e:rs|:ɪ::m:ə:rs	11
in	:i:n|:ɪ:n	6587
inderdaad	:i:n:d:e:r:d:aa:d|:ɪ:n:d:ə:r:d:aː:t	8
indiaan	:i:n:d:i:::aa:n|:ɪ:n:d:iː::j:aː:n	11
indianen	:i:n:d:i:::a::n:e:n|:ɪ:n:d:iː::j:aː::n:ə:	7
indraaien	:i:n:dr:aa:i::e:n|:ɪ:n:dr:aː::j:ə:	2
indruk	:i:n:dr:u:k|:ɪ:n:dr:ʉ:k	2
ineen	:i:n::ee:n|:ɪ:n::eː:n	2
ineens	:i:n::ee:ns|:ɪ:n::eː:ns	138
ingang	:i:n:g:a:ng|:ɪ:ŋ:ɣ:ɑ:ŋ	7
ingepakt	:i:n:g:e::p:a:kt|:ɪ:ŋ:ɣ:ə::p:ɑ:kt	4
inhoud	:i:n:h:ou:d|:ɪ:n:h:ɑu:t	2
inkt	:i:nkt|:ɪ:ŋkt	35
inktvis	:i:nkt:v:i:s|:ɪ:ŋkt:f:ɪ:s	6
inmaken	:i:n:m:a::k:e:n|:ɪ:n:m:aː::k:ə:	2
inpakken	:i:n:p:a:k:k:e:n|:ɪ:m:p:ɑ::k:ə:	12
instappen	:i:n:st:a:p:p:e:n|:ɪ:n:st:ɑ::p:ə:	7
instrument	:i:n:str:u::m:e:nt|:ɪ:n:str:yː::m:ɛ:nt	6
intussen	:i:n:t:u:s:s:e:n|:ɪ:n:t:ʉ::s:ə:	7
invoeren	:i:n:v:oe::r:e:n|:ɪ:n:v:uː::r:ə:	2
inzit	:i:n:z:i:t|:ɪ:n:z:ɪ:t	3
is	:i:s|:ɪ:s	11131
j	j::|j:eː:	568
ja	j:a:|j:aː:	655
jaag	j:aa:g|j:aː:ç	16
jaagt	j:aa:gt|j:aː:çt	8
jaap	j:aa:p|j:aː:p	64
jaar	j:aa:r|j:aː:r	146
jacht	j:a:cht|j:ɑ:çt	7
jack	j:a:ck|j:ɛ:k	2
jagen	j:a::g:e:n|j:aː::ɣ:ə:	9
jager	j:a::g:e:r|j:aː::ɣ:ə:r	18
jagers	j:a::g:e:rs|j:aː::ɣ:ə:rs	2
jakkes	j:a:k:k:e:s|j:ɑ::k:ə:s	2
jaloers	j:a::l:oe:rs|j:aː::l:uː:rs	5
jam	j:a:m|j:ɑ:m	10
jam	j:a:m|ʒ:ɛ:m	10
jam	j:a:m|ʤ:ɛ:m	10
jammer	j:a:m:m:e:r|j:ɑ::m:ə:r	48
jammert	j:a:m:m:e:rt|j:ɑ::m:ə:rt	8
jan	j:a:n|j:ɑ:n	207
jank	j:a:nk|j:ɑ:ŋk	15
janken	j:a:n:k:e:n|j:ɑ:ŋ:k:ə:	3
jankt	j:a:nkt|j:ɑ:ŋkt	9
jans	j:a:ns|j:ɑ:ns	80
janus	j:a::n:u:s|j:aː::n:ʉ:s	98
japans	j:a::p:a:ns|j:aː::p:ɑ:ns	3
jaren	j:a::r:e:n|j:aː::r:ə:	7
jarig	j:a::r:i:g|j:aː::r:ə:ç	58
jas	j:a:s|j:ɑ:s	248
jasje	j:a:s:j:e:|j:ɑ:s:j:ə:	14
jasjes	j:a:s:j:e:s|j:ɑ:s:j:ə:s	7
jassen	j:a:s:s:e:n|j:ɑ::s:ə:	16
jaszak	j:a:s:z:a:k|j:ɑ::s:ɑ:k	22
jat	j:a:t|j:ɑ:t	13
jawel	j:a::w:e:l|j:aː::w:ɛ:l	13
je	j:e:|j:ə:	5779
jee	j:ee:|j:eː:	14
jet	j:e:t|j:ɛ:t	82
jet	j:e:t|ʤ:ɛ:t	82
jeuk	j:eu:k|j:øː:k	22
jeukt	j:eu:kt|j:øː:kt	19
jewelste	j:e::w:e:l:st:e:|j:ə::w:ɛ:l:st:ə:	2
jezelf	j:e::z:e:lf|j:ə::z:ɛ:lf	21
jij	j:ij:|j:ɛi:	1207
jijzelf	j:ij::z:e:lf|j:ɛi::z:ɛ:lf	3
jo	j:o:|j:oː:	13
job	j:o:b|j:ɔ:p	14
joe	j:oe:|j:uː:	30
joelt	j:oe:lt|j:uː:lt	5
joep	j:oe:p|j:uː:p	53
joh	j:o:h|j:ɔ:	5
jok	j:o:k|j:ɔ:k	5
joke	j:o:ke|ʤ:oː:k	2
jokken	j:o:k:k:e:n|j:ɔ::k:ə:	5
jokt	j:o:kt|j:ɔ:kt	2
jong	j:o:ng|j:ɔ:ŋ	37
jonge	j:o:n:g:e:|j:ɔ::ŋ:ə:	23
jongen	j:o:n:g:e:n|j:ɔ::ŋ:ə:	149
jongens	j:o:n:g:e:ns|j:ɔ::ŋ:ə:ns	69
jonger	j:o:n:g:e:r|j:ɔ::ŋ:ə:r	6
jongetje	j:o:n:g:e:n:tj:e:|j:ɔ::ŋ:ə::tj:ə:	24
jonkies	j:o:n:k:ie:s|j:ɔ:ŋ:k:iː:s	2
joon	j:oo:n|j:oː:n	74
joop	j:oo:p|j:oː:p	53
joost	j:oo:st|j:oː:st	72
jou	j:ou:|j:ɑu:	387
jouw	j:ou:w|j:ɑu:w	108
ju	j:u:|j:yː:	2
judo	j:u::d:o:|j:yː::d:oː:	2
juf	j:u:f|j:ʉ:f	535
juffen	j:u:f:f:e:n|j:ʉ::f:ə:	5
juichen	j:ui::ch:e:n|j:œy::ç:ə:	10
juicht	j:ui:cht|j:œy:çt	16
juist	j:ui:st|j:œy:st	69
juiste	j:ui:s:t:e:|j:œy:s:t:ə:	32
juk	j:u:k|j:ʉ:k	4
juli	j:u::l:i:|j:yː::l:iː:	16
jullie	j:u:l:l:ie:|j:ʉ::l:iː:	301
jurk	j:u:rk|j:ʉ:rk	90
jurken	j:u:r:k:e:n|j:ʉ:r:k:ə:	4
jurkje	j:u:rk:j:e:|j:ʉ:rk:j:ə:	3
jury	j:u::r:y:|ʒ:yː::r:iː:	2
jutte	j:u:t:t:e:|j:ʉ::t:ə:	13
jutten	j:u:t:t:e:n|j:ʉ::t:ə:	3
juwelen	j:u::w:e::l:e:n|j:yː::w:eː::l:ə:	2
k	k::|k:aː:	336
ka	k:a:|k:aː:	5
kaak	k:aa:k|k:aː:k	4
kaal	k:aa:l|k:aː:l	25
kaars	k:aa:rs|k:aː:rs	32
kaarsen	k:aa:r:s:e:n|k:aː:r:s:ə:	4
kaarsje	k:aa:rs:j:e:|k:aː:rs:j:ə:	4
kaarsjes	k:aa:rs:j:e:s|k:aː:rs:j:ə:s	12
kaart	k:aa:rt|k:aː:rt	144
kaarten	k:aa:r:t:e:n|k:aː:r:t:ə:	10
kaartje	k:aa:r:tj:e:|k:aː:r:tj:ə:	62
kaartje	k:aa:rt:j:e:|k:aː:rt:j:ə:	62
kaartjes	k:aa:r:tj:e:s|k:aː:r:tj:ə:s	56
kaartjes	k:aa:rt:j:e:s|k:aː:rt:j:ə:s	56
kaas	k:aa:s|k:aː:s	211
kaasje	k:aa:s:j:e:|k:aː:s:j:ə:	6
kabaal	k:a::b:aa:l|k:aː::b:aː:l	3
kabouter	k:a::b:ou::t:e:r|k:aː::b:ɑu::t:ə:r	6
kachel	k:a::ch:e:l|k:ɑ::ç:ə:l	10
kade	k:a::d:e:|k:aː::d:ə:	3
kaft	k:a:ft|k:ɑ:ft	6
kakelen	k:a::k:e::l:e:n|k:aː::k:ə::l:ə:	4
kakelt	k:a::k:e:lt|k:aː::k:ə:lt	2
kaken	k:a::k:e:n|k:aː::k:ə:	4
kale	k:a::l:e:|k:aː::l:ə:	2
kalf	k:a:lf|k:ɑ:lf	27
kalkoen	k:a:l:k:oe:n|k:ɑ:l:k:uː:n	3
kalm	k:a:lm|k:ɑ:lm	15
kam	k:a:m|k:ɑ:m	36
kameel	k:a::m:ee:l|k:aː::m:eː:l	3
kamer	k:a::m:e:r|k:aː::m:ə:r	155
kamers	k:a::m:e:rs|k:aː::m:ə:rs	3
kamertje	k:a::m:e:r:tj:e:|k:aː::m:ə:r:tj:ə:	3
kammetje	k:a:m:m:e::tj:e:|k:ɑ::m:ə::tj:ə:	3
kamp	k:a:mp|k:ɑ:mp	5
kampvuur	k:a:mp:v:uu:r|k:ɑ:mp:f:yː:r	4
kamt	k:a:mt|k:ɑ:mt	12
kan	k:a:n|k:aː:n	1216
kan	k:a:n|k:ɑ:n	1216
kanarie	k:a::n:a::r:ie:|k:aː::n:aː::r:iː:	2
kangoeroe	k:a:n:g:oe::r:oe:|k:ɑ:ŋ:ɣ:uː::r:uː:	6
kannetje	k:a:n:n:e::tj:e:|k:ɑ::n:ə::tj:ə:	2
kans	k:a:ns|k:aː:ns	18
kans	k:a:ns|k:ɑ:ns	18
kant	k:a:nt|k:ɑ:nt	121
kanten	k:a:n:t:e:n|k:ɑ:n:t:ə:	17
kantoor	k:a:n:t:oo:r|k:ɑ:n:t:oː:r	3
kap	k:a:p|k:ɑ:p	4
kapitein	k:a::p:i::t:ei:n|k:ɑ::p:iː::t:ɛi:n	11
kapot	k:a::p:o:t|k:aː::p:ɔ:t	26
kapper	k:a:p:p:e:r|k:ɑ::p:ə:r	7
kapsalon	k:a:p:s:a::l:o:n|k:ɑ:p:s:aː::l:ɔ:n	5
kapstok	k:a:p:st:o:k|k:ɑ:p:st:ɔ:k	13
kapt	k:a:pt|k:ɑ:pt	2
kar	k:a:r|k:ɑ:r	133
karretje	k:a:r:r:e::tj:e:|k:ɑ::r:ə::tj:ə:	8
karton	k:a:r:t:o:n|k:ɑ:r:t:ɔ:n	17
kartonnen	k:a:r:t:o:n:n:e:n|k:ɑ:r:t:ɔ::n:ə:	2
karwei	k:a:r:w:ei:|k:ɑ:r:w:ɛi:	2
kas	k:a:s|k:ɑ:s	54
kassa	k:a:s:s:a:|k:ɑ::s:aː:	22
kast	k:a:st|k:ɑ:st	188
kastanje	k:a:s:t:a:n:j:e:|k:ɑ:s:t:ɑ:n:j:ə:	2
kastanjes	k:a:s:t:a:n:j:e:s|k:ɑ:s:t:ɑ:n:j:ə:s	26
kasteel	k:a:s:t:ee:l|k:ɑ:s:t:eː:l	80
kastelen	k:a:s:t:e::l:e:n|k:ɑ:s:t:eː::l:ə:	2
kasten	k:a:s:t:e:n|k:ɑ:s:t:ə:	10
kastje	k:a:st:j:e:|k:ɑ:st:j:ə:	15
kat	k:a:t|k:ɑ:t	197
kater	k:a::t:e:r|k:aː::t:ə:r	3
katten	k:a:t:t:e:n|k:ɑ::t:ə:	12
kauw	k:au:w|k:ɑu:w	30
kauwen	k:au::w:e:n|k:ɑu::w:ə:	3
kauwgom	k:au:w:g:o:m|k:ɑu:w:ɣ:ɔ:m	4
kauwgum	k:au:w:g:u:m|k:ɑu:w:ɣ:ʉ:m	2
kauwt	k:au:wt|k:ɑu:wt	6
keek	k:ee:k|k:eː:k	73
keel	k:ee:l|k:eː:l	34
keer	k:ee:r|k:eː:r	396
keert	k:ee:rt|k:eː:rt	19
keertje	k:ee:r:tj:e:|k:eː:r:tj:ə:	2
kees	k:ee:s|k:eː:s	100
keft	k:e:ft|k:ɛ:ft	3
kegel	k:e::g:e:l|k:eː::ɣ:ə:l	2
kegelen	k:e::g:e::l:e:n|k:eː::ɣ:ə::l:ə:	3
kei	k:ei:|k:ɛi:	16
keihard	k:ei::h:a:rd|k:ɛi::h:ɑ:rt	11
keken	k:e::k:e:n|k:eː::k:ə:	7
kelder	k:e:l:d:e:r|k:ɛ:l:d:ə:r	8
ken	k:e:n|k:ɛ:n	90
kende	k:e:n:d:e:|k:ɛ:n:d:ə:	5
kennen	k:e:n:n:e:n|k:ɛ::n:ə:	12
kent	k:e:nt|k:ɛ:nt	69
kerel	k:e::r:e:l|k:eː::r:ə:l	2
keren	k:e::r:e:n|k:eː::r:ə:	4
kerk	k:e:rk|k:ɛ:rk	31
kerken	k:e:r:k:e:n|k:ɛ:r:k:ə:	2
kerktoren	k:e:rk:t:o::r:e:n|k:ɛ:rk:t:oː::r:ə:	6
kermis	k:e:r:m:i:s|k:ɛ:r:m:ɪ:s	19
kermt	k:e:rmt|k:ɛ:rmt	4
kern	k:e:rn|k:ɛ:rn	23
kers	k:e:rs|k:ɛ:rs	17
kersen	k:e:r:s:e:n|k:ɛ:r:s:ə:	3
kerst	k:e:rst|k:ɛ:rst	8
kerstboom	k:e:rst:b:oo:m|k:ɛ:rzd:b:oː:m	11
kerstmis	k:e:rst:m:i:s|k:ɛ:rst:m:ɪ:s	4
ketel	k:e::t:e:l|k:eː::t:ə:l	3
ketting	k:e:t:t:i:ng|k:ɛ::t:ɪ:ŋ	15
kettingen	k:e:t:t:i:n:g:e:n|k:ɛ::t:ɪ::ŋ:ə:	2
keuken	k:eu::k:e:n|k:øː::k:ə:	84
keukendeur	k:eu::k:e:n:d:eu:r|k:øː::k:ə:n:d:øː:r	3
keukentafel	k:eu::k:e:n:t:a::f:e:l|k:øː::k:ə:n:t:aː::f:ə:l	2
keukentje	k:eu::k:e:n:tj:e:|k:øː::k:ə:n:tj:ə:	2
keur	k:eu:r|k:øː:r	4
keurig	k:eu::r:i:g|k:øː::r:ə:ç	13
keurt	k:eu:rt|k:øː:rt	2
keus	k:eu:s|k:øː:s	7
keuze	k:eu::z:e:|k:øː::z:ə:	2
kever	k:e::v:e:r|k:eː::v:ə:r	4
kiept	k:ie:pt|k:iː:pt	3
kier	k:ie:r|k:iː:r	20
kiertje	k:ie:r:tj:e:|k:iː:r:tj:ə:	3
kies	k:ie:s|k:iː:s	90
kiespijn	k:ie:s:p:ij:n|k:iː:s:p:ɛi:n	3
kiest	k:ie:st|k:iː:st	12
kietelt	k:ie::t:e:lt|k:iː::t:ə:lt	4
kieuw	k:ie:uw|k:iː:w	11
kiezen	k:ie::z:e:n|k:iː::z:ə:	25
kijf	k:ij:f|k:ɛi:f	2
kijk	k:ij:k|k:ɛi:k	701
kijkdag	k:ij:k:d:a:g|k:ɛi:ɡ:d:ɑ:ç	2
kijkdoos	k:ij:k:d:oo:s|k:ɛi:ɡ:d:oː:s	17
kijken	k:ij::k:e:n|k:ɛi::k:ə:	323
kijkers	k:ij::k:e:rs|k:ɛi::k:ə:rs	4
kijkje	k:ij:k:j:e:|k:ɛi:k:j:ə:	3
kijkt	k:ij:kt|k:ɛi:kt	1270
kik	k:i:k|k:ɪ:k	3
kikker	k:i:k:k:e:r|k:ɪ::k:ə:r	131
kikkers	k:i:k:k:e:rs|k:ɪ::k:ə:rs	7
kikkertje	k:i:k:k:e:r:tj:e:|k:ɪ::k:ə:r:tj:ə:	6
kil	k:i:l|k:ɪ:l	11
kilo	k:i::l:o:|k:iː::l:oː:	14
kilometer	k:i::l:o::m:e::t:e:r|k:iː::l:oː::m:eː::t:ə:r	5
kim	k:i:m|k:ɪ:m	541
kin	k:i:n|k:ɪ:n	40
kind	k:i:nd|k:ɪ:nt	150
kinderboerderij	k:i:n:d:e:r:b:oe:r:d:e::r:ij:|k:ɪ:n:d:ə:r:b:uː:r:d:ə::r:ɛi:	3
kinderen	k:i:n:d:e::r:e:n|k:ɪ:n:d:ə::r:ə:	220
kindje	k:i:nd:j:e:|k:ɪ:nt:j:ə:	9
kindjes	k:i:nd:j:e:s|k:ɪ:nt:j:ə:s	2
kip	k:i:p|k:ɪ:p	287
kippen	k:i:p:p:e:n|k:ɪ::p:ə:	33
kippetje	k:i:p:p:e::tj:e:|k:ɪ::p:ə::tj:ə:	2
kist	k:i:st|k:ɪ:st	129
kisten	k:i:s:t:e:n|k:ɪ:s:t:ə:	4
kistje	k:i:st:j:e:|k:ɪ:st:j:ə:	17
kiwi	k:i::w:i:|k:iː::w:iː:	4
klaagt	kl:aa:gt|kl:aː:çt	2
klaar	kl:aa:r|kl:aː:r	267
klaarwakker	kl:aa:r:w:a:k:k:e:r|kl:aː:r:w:ɑ::k:ə:r	3
klaas	kl:aa:s|kl:aː:s	29
klacht	kl:a:cht|kl:ɑ:çt	2
klagen	kl:a::g:e:n|kl:aː::ɣ:ə:	6
klak	kl:a:k|kl:ɑ:k	3
klank	kl:a:nk|kl:ɑ:ŋk	6
klant	kl:a:nt|kl:ɑ:nt	26
klanten	kl:a:n:t:e:n|kl:ɑ:n:t:ə:	3
klap	kl:a:p|kl:ɑ:p	26
klappen	kl:a:p:p:e:n|kl:ɑ::p:ə:	33
klaproos	kl:a:p:r:oo:s|kl:ɑ:p:r:oː:s	17
klapt	kl:a:pt|kl:ɑ:pt	45
klas	kl:a:s|kl:ɑ:s	184
klassen	kl:a:s:s:e:n|kl:ɑ::s:ə:	2
klautert	kl:au::t:e:rt|kl:ɑu::t:ə:rt	3
klauw	kl:au:w|kl:ɑu:w	5
klauwen	kl:au::w:e:n|kl:ɑu::w:ə:	8
kleden	kl:e::d:e:n|kl:eː::d:ə:	4
kleding	kl:e::d:i:ng|kl:eː::d:ɪ:ŋ	3
kleed	kl:ee:d|kl:eː:t	13
kleedhokje	kl:ee:d:h:o:k:j:e:|kl:eː:t:h:ɔ:k:j:ə:	2
kleedkamer	kl:ee:d:k:a::m:e:r|kl:eː:t:k:aː::m:ə:r	5
kleedt	kl:ee:dt|kl:eː:t	4
kleeft	kl:ee:ft|kl:eː:ft	7
klei	kl:ei:|kl:ɛi:	53
klein	kl:ei:n|kl:ɛi:n	248
kleine	kl:ei::n:e:|kl:ɛi::n:ə:	180
kleiner	kl:ei::n:e:r|kl:ɛi::n:ə:r	20
kleinst	kl:ei:nst|kl:ɛi:nst	3
kleinste	kl:ei:n:st:e:|kl:ɛi:n:st:ə:	3
kleintje	kl:ei:n:tj:e:|kl:ɛi:n:tj:ə:	8
klem	kl:e:m|kl:ɛ:m	13
klemt	kl:e:mt|kl:ɛ:mt	7
klep	kl:e:p|kl:ɛ:p	18
kleren	kl:e::r:e:n|kl:eː::r:ə:	67
klets	kl:e:ts|kl:ɛ:ts	2
kletsen	kl:e:t:s:e:n|kl:ɛ:t:s:ə:	6
kletsnat	kl:e:ts:n:a:t|kl:ɛ:ts:n:ɑ:t	5
kletter	kl:e:t:t:e:r|kl:ɛ::t:ə:r	4
klettert	kl:e:t:t:e:rt|kl:ɛ::t:ə:rt	3
kleur	kl:eu:r|kl:øː:r	64
kleurboek	kl:eu:r:b:oe:k|kl:øː:r:b:uː:k	7
kleuren	kl:eu::r:e:n|kl:øː::r:ə:	27
kleurige	kl:eu::r:i::g:e:|kl:øː::r:ə::ɣ:ə:	2
kleurt	kl:eu:rt|kl:øː:rt	6
kleurtje	kl:eu:r:tj:e:|kl:øː:r:tj:ə:	3
kleuter	kl:eu::t:e:r|kl:øː::t:ə:r	3
kleuters	kl:eu::t:e:rs|kl:øː::t:ə:rs	16
kleven	kl:e::v:e:n|kl:eː::v:ə:	4
klier	kl:ie:r|kl:iː:r	9
klieren	kl:ie::r:e:n|kl:iː::r:ə:	2
klik	kl:i:k|kl:ɪ:k	11
klikken	kl:i:k:k:e:n|kl:ɪ::k:ə:	2
klikt	kl:i:kt|kl:ɪ:kt	4
klim	kl:i:m|kl:ɪ:m	14
klimmen	kl:i:m:m:e:n|kl:ɪ::m:ə:	24
klimrek	kl:i:m:r:e:k|kl:ɪ:m:r:ɛ:k	21
klimt	kl:i:mt|kl:ɪ:mt	82
kling	kl:i:ng|kl:ɪ:ŋ	13
klink	kl:i:nk|kl:ɪ:ŋk	4
klinken	kl:i:n:k:e:n|kl:ɪ:ŋ:k:ə:	5
klinkt	kl:i:nkt|kl:ɪ:ŋkt	126
klodders	kl:o:d:d:e:rs|kl:ɔ::d:ə:rs	2
klok	kl:o:k|kl:ɔ:k	72
klokje	kl:o:k:j:e:|kl:ɔ:k:j:ə:	4
klokken	kl:o:k:k:e:n|kl:ɔ::k:ə:	7
klom	kl:o:m|kl:ɔ:m	4
klomp	kl:o:mp|kl:ɔ:mp	11
klompen	kl:o:m:p:e:n|kl:ɔ:m:p:ə:	2
klompje	kl:o:mp:j:e:|kl:ɔ:mp:j:ə:	2
klonk	kl:o:nk|kl:ɔ:ŋk	5
klontje	kl:o:nt:j:e:|kl:ɔ:nt:j:ə:	2
klontjes	kl:o:nt:j:e:s|kl:ɔ:nt:j:ə:s	7
klop	kl:o:p|kl:ɔ:p	13
kloppen	kl:o:p:p:e:n|kl:ɔ::p:ə:	10
klopt	kl:o:pt|kl:ɔ:pt	62
klots	kl:o:ts|kl:ɔ:ts	3
klotst	kl:o:tst|kl:ɔ:tst	2
kluif	kl:ui:f|kl:œy:f	3
kluns	kl:u:ns|kl:ʉ:ns	2
klusjes	kl:u:s:j:e:s|kl:ʉ:s:j:ə:s	2
knaagt	kn:aa:gt|kn:aː:çt	9
knakworst	kn:a:k:w:o:rst|kn:ɑ:k:w:ɔ:rst	6
knal	kn:a:l|kn:ɑ:l	17
knalgeel	kn:a:l:g:ee:l|kn:ɑ:l:ɣ:eː:l	2
knalrode	kn:a:l:r:o::d:e:|kn:ɑ:l:r:oː::d:ə:	2
knalrood	kn:a:l:r:oo:d|kn:ɑ:l:r:oː:t	9
knalt	kn:a:lt|kn:ɑ:lt	8
knap	kn:a:p|kn:ɑ:p	68
knappe	kn:a:p:p:e:|kn:ɑ::p:ə:	11
knapper	kn:a:p:p:e:r|kn:ɑ::p:ə:r	2
knapt	kn:a:pt|kn:ɑ:pt	4
knars	kn:a:rs|kn:ɑ:rs	2
knarst	kn:a:rst|kn:ɑ:rst	3
knecht	kn:e:cht|kn:ɛ:çt	6
kneed	kn:ee:d|kn:eː:t	5
kneedt	kn:ee:dt|kn:eː:t	6
knettert	kn:e:t:t:e:rt|kn:ɛ::t:ə:rt	2
knie	kn:ie:|kn:iː:	26
knielen	kn:ie::l:e:n|kn:iː::l:ə:	2
knielt	kn:ie:lt|kn:iː:lt	2
knijp	kn:ij:p|kn:ɛi:p	4
knijpen	kn:ij::p:e:n|kn:ɛi::p:ə:	2
knijper	kn:ij::p:e:r|kn:ɛi::p:ə:r	3
knijpers	kn:ij::p:e:rs|kn:ɛi::p:ə:rs	3
knijpt	kn:ij:pt|kn:ɛi:pt	18
knikken	kn:i:k:k:e:n|kn:ɪ::k:ə:	12
knikker	kn:i:k:k:e:r|kn:ɪ::k:ə:r	5
knikkeren	kn:i:k:k:e::r:e:n|kn:ɪ::k:ə::r:ə:	6
knikkers	kn:i:k:k:e:rs|kn:ɪ::k:ə:rs	9
knikt	kn:i:kt|kn:ɪ:kt	185
knikte	kn:i:k:t:e:|kn:ɪ:k:t:ə:	4
knip	kn:i:p|kn:ɪ:p	33
knipoog	kn:i:p::oo:g|kn:ɪ:p::oː:ç	5
knipoogt	kn:i:p::oo:gt|kn:ɪ:p::oː:çt	5
knippen	kn:i:p:p:e:n|kn:ɪ::p:ə:	5
knipperen	kn:i:p:p:e::r:e:n|kn:ɪ::p:ə::r:ə:	2
knippert	kn:i:p:p:e:rt|kn:ɪ::p:ə:rt	8
knipt	kn:i:pt|kn:ɪ:pt	27
knoei	kn:oe:i|kn:uː:j	15
knoeien	kn:oe:i::e:n|kn:uː::j:ə:	3
knoeit	kn:oe:it|kn:uː:jt	5
knoop	kn:oo:p|kn:oː:p	39
knoopt	kn:oo:pt|kn:oː:pt	7
knop	kn:o:p|kn:ɔ:p	8
knopen	kn:o::p:e:n|kn:oː::p:ə:	17
knopje	kn:o:p:j:e:|kn:ɔ:p:j:ə:	12
knopjes	kn:o:p:j:e:s|kn:ɔ:p:j:ə:s	4
knorren	kn:o:r:r:e:n|kn:ɔ::r:ə:	3
knorrig	kn:o:r:r:i:g|kn:ɔ::r:ə:ç	2
knort	kn:o:rt|kn:ɔ:rt	13
knot	kn:o:t|kn:ɔ:t	2
knots	kn:o:ts|kn:ɔ:ts	7
knuffel	kn:u:f:f:e:l|kn:ʉ::f:ə:l	25
knuffels	kn:u:f:f:e:ls|kn:ʉ::f:ə:ls	11
knuffelt	kn:u:f:f:e:lt|kn:ʉ::f:ə:lt	6
knul	kn:u:l|kn:ʉ:l	5
knus	kn:u:s|kn:ʉ:s	9
knutsel	kn:u:t:s:e:l|kn:ʉ:t:s:ə:l	6
knutselen	kn:u:t:s:e::l:e:n|kn:ʉ:t:s:ə::l:ə:	6
kocht	k:o:cht|k:ɔ:çt	13
kochten	k:o:ch:t:e:n|k:ɔ:ç:t:ə:	4
koe	k:oe:|k:uː:	268
koeien	k:oe:i::e:n|k:uː::j:ə:	12
koek	k:oe:k|k:uː:k	293
koeken	k:oe::k:e:n|k:uː::k:ə:	4
koekje	k:oe:k:j:e:|k:uː:k:j:ə:	42
koekjes	k:oe:k:j:e:s|k:uː:k:j:ə:s	34
koekoek	k:oe::k:oe:k|k:uː::k:uː:k	20
koektrommel	k:oe:k:tr:o:m:m:e:l|k:uː:k:tr:ɔ::m:ə:l	2
koel	k:oe:l|k:uː:l	11
koelkast	k:oe:l:k:a:st|k:uː:l:k:ɑ:st	25
koelt	k:oe:lt|k:uː:lt	2
koen	k:oe:n|k:uː:n	242
koet	k:oe:t|k:uː:t	3
koetje	k:oe::tj:e:|k:uː::tj:ə:	3
koets	k:oe:ts|k:uː:ts	25
koffer	k:o:f:f:e:r|k:ɔ::f:ə:r	37
koffers	k:o:f:f:e:rs|k:ɔ::f:ə:rs	3
koffertje	k:o:f:f:e:r:tj:e:|k:ɔ::f:ə:r:tj:ə:	8
koffie	k:o:f:f:ie:|k:ɔ::f:iː:	27
kok	k:o:k|k:ɔ:k	110
koken	k:o::k:e:n|k:oː::k:ə:	37
kokos	k:o::k:o:s|k:oː::k:ɔ:s	3
kokosnoot	k:o::k:o:s:n:oo:t|k:oː::k:ɔ:s:n:oː:t	5
koksmuts	k:o:ks:m:u:ts|k:ɔ:ks:m:ʉ:ts	2
kolen	k:o::l:e:n|k:oː::l:ə:	2
kolk	k:o:lk|k:ɔ:lk	2
kom	k:o:m|k:ɔ:m	829
komen	k:o::m:e:n|k:oː::m:ə:	269
komkommer	k:o:m:k:o:m:m:e:r|k:ɔ:m:k:ɔ::m:ə:r	17
kommetje	k:o:m:m:e::tj:e:|k:ɔ::m:ə::tj:ə:	5
kompas	k:o:m:p:a:s|k:ɔ:m:p:ɑ:s	14
komt	k:o:mt|k:ɔ:mt	1181
kon	k:o:n|k:ɔ:n	111
konden	k:o:n:d:e:n|k:ɔ:n:d:ə:	11
konijn	k:o::n:ij:n|k:oː::n:ɛi:n	89
konijnen	k:o::n:ij::n:e:n|k:oː::n:ɛi::n:ə:	3
koning	k:o::n:i:ng|k:oː::n:ɪ:ŋ	204
koningin	k:o::n:i:n:g:i:n|k:oː::n:ɪ::ŋ:ɪ:n	72
kont	k:o:nt|k:ɔ:nt	3
kooi	k:oo:i|k:oː:j	57
kooien	k:oo:i::e:n|k:oː::j:ə:	5
kook	k:oo:k|k:oː:k	143
kookboek	k:oo:k:b:oe:k|k:oː:ɡ:b:uː:k	13
kookt	k:oo:kt|k:oː:kt	62
kookte	k:oo:k:t:e:|k:oː:k:t:ə:	6
kool	k:oo:l|k:oː:l	44
koop	k:oo:p|k:oː:p	111
koopt	k:oo:pt|k:oː:pt	42
koor	k:oo:r|k:oː:r	26
koord	k:oo:rd|k:oː:rt	11
koorddanser	k:oo:rd:d:a:n:s:e:r|k:oː:r:d:ɑ:n:s:ə:r	5
koorts	k:oo:rts|k:oː:rts	15
koos	k:oo:s|k:oː:s	122
kootje	k:oo:t:j:e:|k:oː:t:j:ə:	40
kop	k:o:p|k:ɔ:p	228
kopen	k:o::p:e:n|k:oː::p:ə:	65
kopie	k:o::p:ie:|k:oː::p:iː:	3
kopje	k:o:p:j:e:|k:ɔ:p:j:ə:	39
kopjes	k:o:p:j:e:s|k:ɔ:p:j:ə:s	13
koppen	k:o:p:p:e:n|k:ɔ::p:ə:	7
koppie	k:o:p:p:ie:|k:ɔ::p:iː:	4
koprol	k:o:p:r:o:l|k:ɔ:p:r:ɔ:l	7
kopt	k:o:pt|k:ɔ:pt	3
korst	k:o:rst|k:ɔ:rst	7
kort	k:o:rt|k:ɔ:rt	27
korte	k:o:r:t:e:|k:ɔ:r:t:ə:	23
korter	k:o:r:t:e:r|k:ɔ:r:t:ə:r	3
kortste	k:o:rt:st:e:|k:ɔ:rt:st:ə:	4
kost	k:o:st|k:ɔ:st	17
kou	k:ou:|k:ɑu:	30
koud	k:ou:d|k:ɑu:t	162
koude	k:ou::d:e:|k:ɑu::d:ə:	17
kouder	k:ou::d:e:r|k:ɑu::d:ə:r	10
kous	k:ou:s|k:ɑu:s	13
kraag	kr:aa:g|kr:aː:ç	15
kraai	kr:aa:i|kr:aː:j	31
kraaien	kr:aa:i::e:n|kr:aː::j:ə:	2
kraait	kr:aa:it|kr:aː:jt	4
kraak	kr:aa:k|kr:aː:k	4
kraakt	kr:aa:kt|kr:aː:kt	22
kraakte	kr:aa:k:t:e:|kr:aː:k:t:ə:	4
kraal	kr:aa:l|kr:aː:l	5
kraam	kr:aa:m|kr:aː:m	17
kraampje	kr:aa:m:pj:e:|kr:aː:m:pj:ə:	2
kraan	kr:aa:n|kr:aː:n	27
kraantje	kr:aa:n:tj:e:|kr:aː:n:tj:ə:	2
krab	kr:a:b|kr:ɑ:p	13
krabbelt	kr:a:b:b:e:lt|kr:ɑ::b:ə:lt	3
krabben	kr:a:b:b:e:n|kr:ɑ::b:ə:	10
krabt	kr:a:bt|kr:ɑ:pt	20
kracht	kr:a:cht|kr:ɑ:çt	6
krak	kr:a:k|kr:ɑ:k	12
kraken	kr:a::k:e:n|kr:aː::k:ə:	9
kralen	kr:a::l:e:n|kr:aː::l:ə:	5
kramp	kr:a:mp|kr:ɑ:mp	3
krans	kr:a:ns|kr:ɑ:ns	15
krant	kr:a:nt|kr:ɑ:nt	71
kranten	kr:a:n:t:e:n|kr:ɑ:n:t:ə:	14
krantje	kr:a:nt:j:e:|kr:ɑ:nt:j:ə:	3
krap	kr:a:p|kr:ɑ:p	2
kras	kr:a:s|kr:ɑ:s	8
krassen	kr:a:s:s:e:n|kr:ɑ::s:ə:	6
krast	kr:a:st|kr:ɑ:st	11
krat	kr:a:t|kr:ɑ:t	3
kreeft	kr:ee:ft|kr:eː:ft	3
kreeg	kr:ee:g|kr:eː:ç	48
kreet	kr:ee:t|kr:eː:t	2
kregen	kr:e::g:e:n|kr:eː::ɣ:ə:	6
kreng	kr:e:ng|kr:ɛ:ŋ	3
krent	kr:e:nt|kr:ɛ:nt	3
krenten	kr:e:n:t:e:n|kr:ɛ:n:t:ə:	6
kreunt	kr:eu:nt|kr:øː:nt	18
kriebel	kr:ie::b:e:l|kr:iː::b:ə:l	3
kriebels	kr:ie::b:e:ls|kr:iː::b:ə:ls	6
kriebelt	kr:ie::b:e:lt|kr:iː::b:ə:lt	7
krijg	kr:ij:g|kr:ɛi:ç	109
krijgen	kr:ij::g:e:n|kr:ɛi::ɣ:ə:	55
krijgt	kr:ij:gt|kr:ɛi:çt	216
krijsen	kr:ij::s:e:n|kr:ɛi::s:ə:	2
krijst	kr:ij:st|kr:ɛi:st	16
krijt	kr:ij:t|kr:ɛi:t	7
krijtje	kr:ij:t:j:e:|kr:ɛi:t:j:ə:	2
krik	kr:i:k|kr:ɪ:k	3
krimpt	kr:i:mpt|kr:ɪ:mpt	2
kring	kr:i:ng|kr:ɪ:ŋ	31
kringetje	kr:i:n:g:e::tj:e:|kr:ɪ::ŋ:ə::tj:ə:	2
krokodil	kr:o::k:o::d:i:l|kr:oː::k:oː::d:ɪ:l	50
krokodillen	kr:o::k:o::d:i:l:l:e:n|kr:oː::k:oː::d:ɪ::l:ə:	6
krom	kr:o:m|kr:ɔ:m	11
kromhout	kr:o:m:h:ou:t|kr:ɔ:m:h:ɑu:t	7
kromme	kr:o:m:m:e:|kr:ɔ::m:ə:	3
kronen	kr:o::n:e:n|kr:oː::n:ə:	4
kronkelt	kr:o:n:k:e:lt|kr:ɔ:ŋ:k:ə:lt	4
kroon	kr:oo:n|kr:oː:n	84
kroontje	kr:oo:n:tj:e:|kr:oː:n:tj:ə:	14
kroop	kr:oo:p|kr:oː:p	5
kroos	kr:oo:s|kr:oː:s	3
kruid	kr:ui:d|kr:œy:t	5
kruiden	kr:ui::d:e:n|kr:œy::d:ə:	5
kruik	kr:ui:k|kr:œy:k	7
kruimel	kr:ui::m:e:l|kr:œy::m:ə:l	2
kruimels	kr:ui::m:e:ls|kr:œy::m:ə:ls	3
kruin	kr:ui:n|kr:œy:n	4
kruip	kr:ui:p|kr:œy:p	18
kruipen	kr:ui::p:e:n|kr:œy::p:ə:	25
kruipt	kr:ui:pt|kr:œy:pt	88
kruis	kr:ui:s|kr:œy:s	19
kruisje	kr:ui:s:j:e:|kr:œy:s:j:ə:	11
kruispunt	kr:ui:s:p:u:nt|kr:œy:s:p:ʉ:nt	4
kruiwagen	kr:ui::w:a::g:e:n|kr:œy::w:aː::ɣ:ə:	11
kruk	kr:u:k|kr:ʉ:k	16
krukken	kr:u:k:k:e:n|kr:ʉ::k:ə:	2
krul	kr:u:l|kr:ʉ:l	20
krullen	kr:u:l:l:e:n|kr:ʉ::l:ə:	11
krult	kr:u:lt|kr:ʉ:lt	6
kuch	k:u:ch|k:ʉ:ç	2
kucht	k:u:cht|k:ʉ:çt	15
kuif	k:ui:f|k:œy:f	8
kuiken	k:ui::k:e:n|k:œy::k:ə:	12
kuil	k:ui:l|k:œy:l	70
kuilen	k:ui::l:e:n|k:œy::l:ə:	8
kuiltje	k:ui:l:tj:e:|k:œy:l:tj:ə:	2
kuipers	k:ui::p:e:rs|k:œy::p:ə:rs	3
kuit	k:ui:t|k:œy:t	2
kun	k:u:n|k:ʉ:n	189
kunnen	k:u:n:n:e:n|k:ʉ::n:ə:	205
kunst	k:u:nst|k:ʉ:nst	31
kunstje	k:u:nst:j:e:|k:ʉ:nst:j:ə:	11
kunstjes	k:u:nst:j:e:s|k:ʉ:nst:j:ə:s	16
kunt	k:u:nt|k:ʉ:nt	156
kurk	k:u:rk|k:ʉ:rk	7
kus	k:u:s|k:ʉ:s	95
kusje	k:u:s:j:e:|k:ʉ:s:j:ə:	6
kusjes	k:u:s:j:e:s|k:ʉ:s:j:ə:s	6
kussen	k:u:s:s:e:n|k:ʉ::s:ə:	29
kussens	k:u:s:s:e:ns|k:ʉ::s:ə:ns	5
kust	k:u:st|k:ʉ:st	17
kwaad	kw:aa:d|kw:aː:t	26
kwaak	kw:aa:k|kw:aː:k	3
kwaakt	kw:aa:kt|kw:aː:kt	13
kwaal	kw:aa:l|kw:aː:l	2
kwal	kw:a:l|kw:ɑ:l	41
kwallen	kw:a:l:l:e:n|kw:ɑ::l:ə:	14
kwam	kw:a:m|kw:ɑ:m	149
kwamen	kw:a::m:e:n|kw:aː::m:ə:	19
kwark	kw:a:rk|kw:ɑ:rk	3
kwart	kw:a:rt|kw:ɑ:rt	3
kwartier	kw:a:r:t:ie:r|kw:ɑ:r:t:iː:r	6
kwast	kw:a:st|kw:ɑ:st	21
kwasten	kw:a:s:t:e:n|kw:ɑ:s:t:ə:	4
kwijlt	kw:ij:lt|kw:ɛi:lt	3
kwijt	kw:ij:t|kw:ɛi:t	71
kwispelt	kw:i:s:p:e:lt|kw:ɪ:s:p:ə:lt	6
l	l::|:ɛ:l	550
la	l:a:|l:aː:	45
laad	l:aa:d|l:aː:t	2
laag	l:aa:g|l:aː:ç	29
laagst	l:aa:gst|l:aː:çst	2
laagste	l:aa:g:st:e:|l:aː:ç:st:ə:	2
laan	l:aa:n|l:aː:n	7
laar	l:aa:r|l:aː:r	2
laars	l:aa:rs|l:aː:rs	17
laarsjes	l:aa:rs:j:e:s|l:aː:rs:j:ə:s	7
laarzen	l:aa:r:z:e:n|l:aː:r:z:ə:	23
laat	l:aa:t|l:aː:t	428
laatst	l:aa:tst|l:aː:tst	12
laatste	l:aa:t:st:e:|l:aː:t:st:ə:	51
lach	l:a:ch|l:ɑ:ç	41
lachen	l:a::ch:e:n|l:ɑ::ç:ə:	120
lachend	l:a::ch:e:nd|l:ɑ::ç:ə:nt	19
lacht	l:a:cht|l:ɑ:çt	474
lachte	l:a:ch:t:e:|l:ɑ:ç:t:ə:	9
ladder	l:a:d:d:e:r|l:ɑ::d:ə:r	27
lag	l:a:g|l:ɑ:ç	56
lage	l:a::g:e:|l:aː::ɣ:ə:	7
lagen	l:a::g:e:n|l:aː::ɣ:ə:	2
lager	l:a::g:e:r|l:aː::ɣ:ə:r	6
lak	l:a:k|l:ɑ:k	9
lakei	l:a::k:ei:|l:aː::k:ɛi:	24
lakeien	l:a::k:ei:::e:n|l:aː::k:ɛi::j:ə:	6
laken	l:a::k:e:n|l:aː::k:ə:	8
lakens	l:a::k:e:ns|l:aː::k:ə:ns	2
lam	l:a:m|l:ɑ:m	142
lammetje	l:a:m:m:e::tj:e:|l:ɑ::m:ə::tj:ə:	10
lamp	l:a:mp|l:ɑ:mp	71
lampen	l:a:m:p:e:n|l:ɑ:m:p:ə:	7
lampje	l:a:mp:j:e:|l:ɑ:mp:j:ə:	3
land	l:a:nd|l:ɑ:nt	97
landen	l:a:n:d:e:n|l:ɑ:n:d:ə:	27
landing	l:a:n:d:i:ng|l:ɑ:n:d:ɪ:ŋ	3
landkaart	l:a:nd:k:aa:rt|l:ɑ:nt:k:aː:rt	10
landt	l:a:ndt|l:ɑ:nt	13
lang	l:a:ng|l:ɑ:ŋ	310
lange	l:a:n:g:e:|l:ɑ::ŋ:ə:	82
langer	l:a:n:g:e:r|l:ɑ::ŋ:ə:r	21
langs	l:a:ngs|l:ɑ:ŋs	135
langskomen	l:a:ngs:k:o::m:e:n|l:ɑ:ŋs:k:oː::m:ə:	2
langste	l:a:ng:st:e:|l:ɑ:ŋ:st:ə:	3
languit	l:a:ng::ui:t|l:ɑ:ŋ::œy:t	3
langzaam	l:a:ng:z:aa:m|l:ɑ:ŋ:z:aː:m	67
langzamer	l:a:ng:z:a::m:e:r|l:ɑ:ŋ:z:aː::m:ə:r	3
lans	l:a:ns|l:ɑ:ns	4
lap	l:a:p|l:ɑ:p	41
lapje	l:a:p:j:e:|l:ɑ:p:j:ə:	4
lappen	l:a:p:p:e:n|l:ɑ::p:ə:	4
las	l:a:s|l:ɑ:s	37
last	l:a:st|l:ɑ:st	14
lastig	l:a:s:t:i:g|l:ɑ:s:t:ə:ç	19
lat	l:a:t|l:ɑ:t	11
laten	l:a::t:e:n|l:aː::t:ə:	105
later	l:a::t:e:r|l:aː::t:ə:r	140
lauw	l:au:w|l:ɑu:w	17
lawaai	l:a::w:aa:i|l:aː::w:aː:j	21
lazen	l:a::z:e:n|l:aː::z:ə:	5
leed	l:ee:d|l:eː:t	2
leef	l:ee:f|l:eː:f	8
leefden	l:ee:f:d:e:n|l:eː:v:d:ə:	2
leeft	l:ee:ft|l:eː:ft	32
leeftijd	l:ee:f:t:ij:d|l:eː:f:t:ɛi:t	2
leeg	l:ee:g|l:eː:ç	128
leek	l:ee:k|l:eː:k	20
leen	l:ee:n|l:eː:n	10
leer	l:ee:r|l:eː:r	31
leerde	l:ee:r:d:e:|l:eː:r:d:ə:	7
leerden	l:ee:r:d:e:n|l:eː:r:d:ə:	2
leert	l:ee:rt|l:eː:rt	21
lees	l:ee:s|l:eː:s	186
leesboek	l:ee:s:b:oe:k|l:eː:z:b:uː:k	16
leesbril	l:ee:s:br:i:l|l:eː:z:br:ɪ:l	9
leesonderwijs	l:ee:s::o:n:d:e:r:w:ij:s|l:eː:s::ɔ:n:d:ə:r:w:ɛi:s	4
leest	l:ee:st|l:eː:st	186
leeuw	l:ee:uw|l:eː:w	144
leeuwen	l:ee:uw::e:n|l:eː::w:ə:	16
leeuwin	l:ee:uw::i:n|l:eː::w:ɪ:n	2
lef	l:e:f|l:ɛ:f	2
leg	l:e:g|l:ɛ:ç	101
legde	l:e:g:d:e:|l:ɛ:ɣ:d:ə:	7
lege	l:e::g:e:|l:eː::ɣ:ə:	22
leger	l:e::g:e:r|l:eː::ɣ:ə:r	5
leggen	l:e:g:g:e:n|l:ɛ::ɣ:ə:	28
lego	l:e::g:o:|l:eː::ɣ:oː:	3
legt	l:e:gt|l:ɛ:çt	228
leider	l:ei::d:e:r|l:ɛi::d:ə:r	4
leiding	l:ei::d:i:ng|l:ɛi::d:ɪ:ŋ	3
lek	l:e:k|l:ɛ:k	18
lekken	l:e:k:k:e:n|l:ɛ::k:ə:	2
lekker	l:e:k:k:e:r|l:ɛ::k:ə:r	281
lekkere	l:e:k:k:e::r:e:|l:ɛ::k:ə::r:ə:	11
lekkers	l:e:k:k:e:rs|l:ɛ::k:ə:rs	25
lekkerst	l:e:k:k:e:rst|l:ɛ::k:ə:rst	3
lekkerste	l:e:k:k:e:r:st:e:|l:ɛ::k:ə:r:st:ə:	5
lelijk	l:e::l:ij:k|l:eː::l:ə:k	14
lenen	l:e::n:e:n|l:eː::n:ə:	14
lengte	l:e:ng:t:e:|l:ɛ:ŋ:t:ə:	11
lenig	l:e::n:i:g|l:eː::n:ə:ç	4
lening	l:e::n:i:ng|l:eː::n:ɪ:ŋ	2
lens	l:e:ns|l:ɛ:ns	2
lente	l:e:n:t:e:|l:ɛ:n:t:ə:	41
lepel	l:e::p:e:l|l:eː::p:ə:l	13
lepels	l:e::p:e:ls|l:eː::p:ə:ls	8
lepeltje	l:e::p:e:l:tj:e:|l:eː::p:ə:l:tj:ə:	8
leren	l:e::r:e:n|l:eː::r:ə:	72
les	l:e:s|l:ɛ:s	50
lesje	l:e:s:j:e:|l:ɛ:s:j:ə:	9
let	l:e:t|l:ɛ:t	64
letten	l:e:t:t:e:n|l:ɛ::t:ə:	4
letter	l:e:t:t:e:r|l:ɛ::t:ə:r	22
letters	l:e:t:t:e:rs|l:ɛ::t:ə:rs	46
leuk	l:eu:k|l:øː:k	582
leuke	l:eu::k:e:|l:øː::k:ə:	53
leuker	l:eu::k:e:r|l:øː::k:ə:r	25
leukst	l:eu:kst|l:øː:kst	21
leukste	l:eu:k:st:e:|l:øː:k:st:ə:	20
leun	l:eu:n|l:øː:n	8
leunen	l:eu::n:e:n|l:øː::n:ə:	2
leuning	l:eu::n:i:ng|l:øː::n:ɪ:ŋ	8
leunstoel	l:eu:n:st:oe:l|l:øː:n:st:uː:l	3
leunt	l:eu:nt|l:øː:nt	11
leven	l:e::v:e:n|l:eː::v:ə:	61
levend	l:e::v:e:nd|l:eː::v:ə:nt	2
levensgevaarlijk	l:e::v:e:ns:g:e::v:aa:r:l:ij:k|l:eː::v:ə:s:ç:ə::v:aː:r:l:ə:k	4
lever	l:e::v:e:r|l:eː::v:ə:r	2
lezen	l:e::z:e:n|l:eː::z:ə:	152
lichaam	l:i::ch:aa:m|l:ɪ::ç:aː:m	2
licht	l:i:cht|l:ɪ:çt	127
lichtblauw	l:i:cht:bl:au:w|l:ɪ:ɣd:bl:ɑu:w	2
lichtbruin	l:i:cht:br:ui:n|l:ɪ:ɣd:br:œy:n	2
lichtje	l:i:cht:j:e:|l:ɪ:çt:j:ə:	3
lichtjes	l:i:cht:j:e:s|l:ɪ:çt:j:ə:s	8
lichtstraal	l:i:cht:str:aa:l|l:ɪ:çt:str:aː:l	2
lied	l:ie:d|l:iː:t	79
liedje	l:ie:d:j:e:|l:iː:t:j:ə:	25
liedjes	l:ie:d:j:e:s|l:iː:t:j:ə:s	12
lief	l:ie:f|l:iː:f	180
liefde	l:ie:f:d:e:|l:iː:v:d:ə:	4
liefst	l:ie:fst|l:iː:fst	39
liefste	l:ie:f:st:e:|l:iː:f:st:ə:	12
lieg	l:ie:g|l:iː:ç	5
liegbeest	l:ie:g:b:ee:st|l:iː:ɣ:b:eː:st	5
liegen	l:ie::g:e:n|l:iː::ɣ:ə:	4
liegt	l:ie:gt|l:iː:çt	12
liep	l:ie:p|l:iː:p	67
liepen	l:ie::p:e:n|l:iː::p:ə:	12
lies	l:ie:s|l:iː:s	86
liet	l:ie:t|l:iː:t	16
lieten	l:ie::t:e:n|l:iː::t:ə:	4
lieve	l:ie::v:e:|l:iː::v:ə:	53
lievelingsboek	l:ie::v:e::l:i:ngs:b:oe:k|l:iː::v:ə::l:ɪ:ŋz:b:uː:k	31
liever	l:ie::v:e:r|l:iː::v:ə:r	50
lieverd	l:ie::v:e:rd|l:iː::v:ə:rt	15
lift	l:i:ft|l:ɪ:ft	8
lig	l:i:g|l:ɪ:ç	30
liggen	l:i:g:g:e:n|l:ɪ::ɣ:ə:	115
ligstoel	l:i:g:st:oe:l|l:ɪ:ç:st:uː:l	4
ligt	l:i:gt|l:ɪ:çt	432
lijf	l:ij:f|l:ɛi:f	45
lijk	l:ij:k|l:ɛi:k	14
lijken	l:ij::k:e:n|l:ɛi::k:ə:	17
lijkt	l:ij:kt|l:ɛi:kt	219
lijm	l:ij:m|l:ɛi:m	43
lijmt	l:ij:mt|l:ɛi:mt	4
lijn	l:ij:n|l:ɛi:n	57
lijntje	l:ij:n:tj:e:|l:ɛi:n:tj:ə:	2
lijntjes	l:ij:n:tj:e:s|l:ɛi:n:tj:ə:s	3
lijst	l:ij:st|l:ɛi:st	11
lik	l:i:k|l:ɪ:k	22
likken	l:i:k:k:e:n|l:ɪ::k:ə:	2
likt	l:i:kt|l:ɪ:kt	33
likte	l:i:k:t:e:|l:ɪ:k:t:ə:	2
limonade	l:i::m:o::n:a::d:e:|l:iː::m:oː::n:aː::d:ə:	19
link	l:i:nk|l:ɪ:ŋk	6
links	l:i:nks|l:ɪ:ŋks	51
linksaf	l:i:nks::a:f|l:ɪ:ŋks::ɑ:f	4
lint	l:i:nt|l:ɪ:nt	21
lip	l:i:p|l:ɪ:p	27
lippen	l:i:p:p:e:n|l:ɪ::p:ə:	19
lippenstift	l:i:p:p:e:n:st:i:ft|l:ɪ::p:ə::st:ɪ:ft	3
list	l:i:st|l:ɪ:st	3
liter	l:i::t:e:r|l:iː::t:ə:r	4
loei	l:oe:i|l:uː:j	8
loeit	l:oe:it|l:uː:jt	3
loempia	l:oe:m:p:i:::a:|l:uː:m:p:iː::j:aː:	5
loer	l:oe:r|l:uː:r	6
loeren	l:oe::r:e:n|l:uː::r:ə:	2
loert	l:oe:rt|l:uː:rt	6
logeer	l:o::g:ee:r|l:oː::ʒ:eː:r	2
logeert	l:o::g:ee:rt|l:oː::ʒ:eː:rt	6
logeren	l:o::g:e::r:e:n|l:oː::ʒ:eː::r:ə:	16
lok	l:o:k|l:ɔ:k	3
loket	l:o::k:e:t|l:oː::k:ɛ:t	2
lokken	l:o:k:k:e:n|l:ɔ::k:ə:	2
lokt	l:o:kt|l:ɔ:kt	2
lol	l:o:l|l:ɔ:l	25
lolletje	l:o:l:l:e::tj:e:|l:ɔ::l:ə::tj:ə:	2
lolly	l:o:l:l:y:|l:ɔ::l:iː:	3
long	l:o:ng|l:ɔ:ŋ	7
longen	l:o:n:g:e:n|l:ɔ::ŋ:ə:	2
loog	l:oo:g|l:oː:ç	2
look	l:oo:k|l:oː:k	12
look	l:oo:k|l:uː:k	12
loon	l:oo:n|l:oː:n	4
loop	l:oo:p|l:oː:p	94
loop	l:oo:p|l:uː:p	94
loopplank	l:oo:p:pl:a:nk|l:oː::pl:ɑ:ŋk	4
loopt	l:oo:pt|l:oː:pt	663
lopen	l:o::p:e:n|l:oː::p:ə:	233
los	l:o:s|l:ɔ:s	134
loslaat	l:o:s:l:aa:t|l:ɔ:s:l:aː:t	3
loslaten	l:o:s:l:a::t:e:n|l:ɔ:s:l:aː::t:ə:	3
losse	l:o:s:s:e:|l:ɔ::s:ə:	11
lossen	l:o:s:s:e:n|l:ɔ::s:ə:	2
lost	l:o:st|l:ɔ:st	3
lot	l:o:t|l:ɔ:t	181
loterij	l:o::t:e::r:ij:|l:oː::t:ə::r:ɛi:	2
lotje	l:o:t:j:e:|l:ɔ:t:j:ə:	9
lucht	l:u:cht|l:ʉ:çt	272
luchtballon	l:u:cht:b:a:l:l:o:n|l:ʉ:ɣd:b:ɑ::l:ɔ:n	17
luchtje	l:u:cht:j:e:|l:ʉ:çt:j:ə:	2
luchtvaart	l:u:cht:v:aa:rt|l:ʉ:çt:f:aː:rt	2
luchtzak	l:u:cht:z:a:k|l:ʉ:çt:s:ɑ:k	2
lucifers	l:u::c:i::f:e:rs|l:yː::s:iː::f:ɛ:rs	3
lui	l:ui:|l:œy:	37
luid	l:ui:d|l:œy:t	38
luide	l:ui::d:e:|l:œy::d:ə:	2
luidspreker	l:ui:d:spr:e::k:e:r|l:œy:t:spr:eː::k:ə:r	3
luifel	l:ui::f:e:l|l:œy::f:ə:l	2
luik	l:ui:k|l:œy:k	21
luikje	l:ui:k:j:e:|l:œy:k:j:ə:	3
luipaard	l:ui::p:aa:rd|l:œy::p:aː:rt	2
luis	l:ui:s|l:œy:s	16
luister	l:ui:s:t:e:r|l:œy:s:t:ə:r	34
luisterden	l:ui:s:t:e:r:d:e:n|l:œy:s:t:ə:r:d:ə:	2
luisteren	l:ui:s:t:e::r:e:n|l:œy:s:t:ə::r:ə:	29
luistert	l:ui:s:t:e:rt|l:œy:s:t:ə:rt	24
luizen	l:ui::z:e:n|l:œy::z:ə:	2
lukken	l:u:k:k:e:n|l:ʉ::k:ə:	10
lukt	l:u:kt|l:ʉ:kt	76
lukte	l:u:k:t:e:|l:ʉ:k:t:ə:	2
lust	l:u:st|l:ʉ:st	119
lusten	l:u:s:t:e:n|l:ʉ:s:t:ə:	12
m	m::|:ɛ:m	499
ma	m:a:|m:aː:	22
maag	m:aa:g|m:aː:ç	19
maai	m:aa:i|m:aː:j	10
maait	m:aa:it|m:aː:jt	2
maak	m:aa:k|m:aː:k	543
maakt	m:aa:kt|m:aː:kt	472
maakte	m:aa:k:t:e:|m:aː:k:t:ə:	30
maakten	m:aa:k:t:e:n|m:aː:k:t:ə:	11
maal	m:aa:l|m:aː:l	8
maalt	m:aa:lt|m:aː:lt	2
maaltijd	m:aa:l:t:ij:d|m:aː:l:t:ɛi:t	4
maaltje	m:aa:l:tj:e:|m:aː:l:tj:ə:	3
maan	m:aa:n|m:aː:n	387
maand	m:aa:nd|m:aː:nt	16
maandag	m:aa:n:d:a:g|m:aː:n:d:ɑ:ç	36
maant	m:aa:nt|m:aː:nt	95
maantje	m:aa:n:tj:e:|m:aː:n:tj:ə:	4
maar	m:aa:r|m:aː:r	4461
maart	m:aa:rt|m:aː:rt	4
maarten	m:aa:r:t:e:n|m:aː:r:t:ə:	17
maas	m:aa:s|m:aː:s	18
maat	m:aa:t|m:aː:t	49
maatje	m:a::tj:e:|m:aː::tj:ə:	8
maatje	m:a::tj:e:|m:aː:t:j:ə:	8
macht	m:a:cht|m:ɑ:çt	5
machtig	m:a:ch:t:i:g|m:ɑ:ç:t:ə:ç	5
maf	m:a:f|m:ɑ:f	8
mag	m:a:g|m:ɑ:ç	606
mager	m:a::g:e:r|m:aː::ɣ:ə:r	3
magere	m:a::g:e::r:e:|m:aː::ɣ:ə::r:ə:	2
magneet	m:a:g:n:ee:t|m:ɑ:ɣ:n:eː:t	18
mak	m:a:k|m:ɑ:k	134
maken	m:a::k:e:n|m:aː::k:ə:	250
makkelijk	m:a:k:k:e::l:ij:k|m:ɑ::k:ə::l:ə:k	12
makker	m:a:k:k:e:r|m:ɑ::k:ə:r	2
makkie	m:a:k:k:ie:|m:ɑ::k:iː:	6
mal	m:a:l|m:ɑ:l	8
malen	m:a::l:e:n|m:aː::l:ə:	2
malle	m:a:l:l:e:|m:ɑ::l:ə:	12
mals	m:a:ls|m:ɑ:ls	4
mam	m:a:m|m:ɑ:m	646
mama	m:a::m:a:|m:ɑ::m:aː:	1079
mams	m:a:ms|m:ɑ:ms	37
man	m:a:n|m:ɑ:n	484
mand	m:a:nd|m:ɑ:nt	116
manden	m:a:n:d:e:n|m:ɑ:n:d:ə:	6
mandje	m:a:nd:j:e:|m:ɑ:nt:j:ə:	8
manen	m:a::n:e:n|m:aː::n:ə:	5
manier	m:a::n:ie:r|m:aː::n:iː:r	12
manieren	m:a::n:ie::r:e:n|m:aː::n:iː::r:ə:	3
mank	m:a:nk|m:ɑ:ŋk	24
mannen	m:a:n:n:e:n|m:ɑ::n:ə:	62
mannetje	m:a:n:n:e::tj:e:|m:ɑ::n:ə::tj:ə:	17
map	m:a:p|m:ɑ:p	2
mar	m:a:r|m:ɑ:r	22
mark	m:a:rk|m:ɑ:rk	66
markt	m:a:rkt|m:ɑ:rkt	26
mart	m:a:rt|m:ɑ:rt	113
masker	m:a:s:k:e:r|m:ɑ:s:k:ə:r	5
mast	m:a:st|m:ɑ:st	23
mat	m:a:t|m:ɑ:t	31
maten	m:a::t:e:n|m:aː::t:ə:	2
matje	m:a:t:j:e:|m:ɑ:t:j:ə:	2
matroos	m:a::tr:oo:s|m:ɑ::tr:oː:s	38
matrozen	m:a::tr:o::z:e:n|m:ɑ::tr:oː::z:ə:	4
mauw	m:au:w|m:ɑu:w	35
mauwt	m:au:wt|m:ɑu:wt	4
me	m:e:|m:ə:	602
mee	m:ee:|m:eː:	1032
meedoen	m:ee::d:oe:n|m:eː::d:uː:n	29
meegaan	m:ee::g:aa:n|m:eː::ɣ:aː:n	4
meegaat	m:ee::g:aa:t|m:eː::ɣ:aː:t	7
meegebracht	m:ee::g:e::br:a:cht|m:eː::ɣ:ə::br:ɑ:çt	4
meegenomen	m:ee::g:e::n:o::m:e:n|m:eː::ɣ:ə::n:oː::m:ə:	8
meel	m:ee:l|m:eː:l	36
meen	m:ee:n|m:eː:n	9
meenemen	m:ee::n:e::m:e:n|m:eː::n:eː::m:ə:	12
meent	m:ee:nt|m:eː:nt	4
meer	m:ee:r|m:eː:r	1079
meermin	m:ee:r:m:i:n|m:eː:r:m:ɪ:n	7
mees	m:ee:s|m:eː:s	182
meespelen	m:ee::sp:e::l:e:n|m:eː::sp:eː::l:ə:	2
meest	m:ee:st|m:eː:st	11
meestal	m:ee:st::a:l|m:eː:st::ɑ:l	18
meeste	m:ee:s:t:e:|m:eː:s:t:ə:	21
meester	m:ee:s:t:e:r|m:eː:s:t:ə:r	22
meesters	m:ee:s:t:e:rs|m:eː:s:t:ə:rs	5
meet	m:ee:t|m:eː:t	38
meeuw	m:ee:uw|m:eː:w	177
meeuwen	m:ee:uw::e:n|m:eː::w:ə:	6
mei	m:ei:|m:ɛi:	117
meid	m:ei:d|m:ɛi:t	17
meiden	m:ei::d:e:n|m:ɛi::d:ə:	2
meisje	m:ei:s:j:e:|m:ɛi:s:j:ə:	126
meisjes	m:ei:s:j:e:s|m:ɛi:s:j:ə:s	35
mek	m:e:k|m:ɛ:k	6
melk	m:e:lk|m:ɛ:lk	113
melodie	m:e::l:o::d:ie:|m:eː::l:oː::d:iː:	4
meloen	m:e::l:oe:n|m:ə::l:uː:n	3
men	m:e:n|m:ɛ:n	22
meneer	m:e::n:ee:r|m:ə::n:eː:r	99
meng	m:e:ng|m:ɛ:ŋ	7
mengsel	m:e:ng:s:e:l|m:ɛ:ŋ:s:ə:l	2
mening	m:e::n:i:ng|m:eː::n:ɪ:ŋ	2
mens	m:e:ns|m:ɛ:ns	104
mensen	m:e:n:s:e:n|m:ɛ:n:s:ə:	343
mep	m:e:p|m:ɛ:p	65
mept	m:e:pt|m:ɛ:pt	8
merel	m:e::r:e:l|m:eː::r:ə:l	2
meren	m:e::r:e:n|m:eː::r:ə:	3
merk	m:e:rk|m:ɛ:rk	9
merken	m:e:r:k:e:n|m:ɛ:r:k:ə:	5
merkt	m:e:rkt|m:ɛ:rkt	20
merkte	m:e:rk:t:e:|m:ɛ:rk:t:ə:	3
mes	m:e:s|m:ɛ:s	122
mesje	m:e:s:j:e:|m:ɛ:s:j:ə:	3
messen	m:e:s:s:e:n|m:ɛ::s:ə:	4
mest	m:e:st|m:ɛ:st	6
met	m:e:t|m:ɛ:t	3415
metaal	m:e::t:aa:l|m:eː::t:aː:l	2
meteen	m:e::t:ee:n|m:ə::t:eː:n	164
meten	m:e::t:e:n|m:eː::t:ə:	7
meter	m:e::t:e:r|m:eː::t:ə:r	19
meubels	m:eu::b:e:ls|m:øː::b:ə:ls	2
mevrouw	m:e::vr:ou:w|m:ə::vr:ɑu:w	76
mezelf	m:e::z:e:lf|m:ə::z:ɛ:lf	11
mi	m:i:|m:iː:	4
middag	m:i:d:d:a:g|m:ɪ::d:ɑ:ç	22
middel	m:i:d:d:e:l|m:ɪ::d:ə:l	4
middelste	m:i:d:d:e:l:st:e:|m:ɪ::d:ə:l:st:ə:	2
midden	m:i:d:d:e:n|m:ɪ::d:ə:	49
mie	m:ie:|m:iː:	63
mier	m:ie:r|m:iː:r	42
mieren	m:ie::r:e:n|m:iː::r:ə:	29
mies	m:ie:s|m:iː:s	14
mij	m:ij:|m:ɛi:	517
mijl	m:ij:l|m:ɛi:l	2
mijn	m:ij:n|m:ɛi:n	1656
mik	m:i:k|m:ɪ:k	49
mikt	m:i:kt|m:ɪ:kt	5
miljoen	m:i:l:j:oe:n|m:ə:l:j:uː:n	7
min	m:i:n|m:ɪ:n	22
minder	m:i:n:d:e:r|m:ɪ:n:d:ə:r	15
minderen	m:i:n:d:e::r:e:n|m:ɪ:n:d:ə::r:ə:	2
mini	m:i::n:i:|m:iː::n:iː:	2
minne	m:i:n:n:e:|m:ɪ::n:ə:	3
minstens	m:i:n:st:e:ns|m:ɪ:n:st:ə:ns	2
minuten	m:i::n:u::t:e:n|m:iː::n:yː::t:ə:	11
minuut	m:i::n:uu:t|m:iː::n:yː:t	9
mis	m:i:s|m:ɪ:s	405
misschien	m:i:s:sch:ie:n|m:ɪ::sç:iː:n	166
misselijk	m:i:s:s:e::l:ij:k|m:ɪ::s:ə::l:ə:k	2
missen	m:i:s:s:e:n|m:ɪ::s:ə:	14
mist	m:i:st|m:ɪ:st	40
miste	m:i:s:t:e:|m:ɪ:s:t:ə:	3
mocht	m:o:cht|m:ɔ:çt	36
mochten	m:o:ch:t:e:n|m:ɔ:ç:t:ə:	9
modder	m:o:d:d:e:r|m:ɔ::d:ə:r	12
modern	m:o::d:e:rn|m:oː::d:ɛ:rn	2
moe	m:oe:|m:uː:	171
moed	m:oe:d|m:uː:t	11
moeder	m:oe::d:e:r|m:uː::d:ə:r	290
moederdag	m:oe::d:e:r:d:a:g|m:uː::d:ə:r:d:ɑ:ç	3
moeders	m:oe::d:e:rs|m:uː::d:ə:rs	13
moedig	m:oe::d:i:g|m:uː::d:ə:ç	4
moeilijk	m:oe:i:l:ij:k|m:uː:j:l:ə:k	48
moeilijker	m:oe:i:l:ij::k:e:r|m:uː:j:l:ə::k:ə:r	4
moeite	m:oe:i:t:e:|m:uː:j:t:ə:	3
moer	m:oe:r|m:uː:r	2
moes	m:oe:s|m:uː:s	25
moest	m:oe:st|m:uː:st	77
moesten	m:oe:s:t:e:n|m:uː:s:t:ə:	13
moet	m:oe:t|m:uː:t	1205
moeten	m:oe::t:e:n|m:uː::t:ə:	201
mogelijk	m:o::g:e::l:ij:k|m:oː::ɣ:ə::l:ə:k	3
mogen	m:o::g:e:n|m:oː::ɣ:ə:	69
mok	m:o:k|m:ɔ:k	36
mokt	m:o:kt|m:ɔ:kt	2
mol	m:o:l|m:ɔ:l	149
molen	m:o::l:e:n|m:oː::l:ə:	15
mollen	m:o:l:l:e:n|m:ɔ::l:ə:	5
molletje	m:o:l:l:e::tj:e:|m:ɔ::l:ə::tj:ə:	2
moment	m:o::m:e:nt|m:oː::m:ɛ:nt	16
mompelt	m:o:m:p:e:lt|m:ɔ:m:p:ə:lt	25
mond	m:o:nd|m:ɔ:nt	88
mondje	m:o:nd:j:e:|m:ɔ:nt:j:ə:	5
monster	m:o:n:st:e:r|m:ɔ:n:st:ə:r	73
monsters	m:o:n:st:e:rs|m:ɔ:n:st:ə:rs	30
mooi	m:oo:i|m:oː:j	335
mooie	m:oo:i::e:|m:oː::j:ə:	100
mooier	m:oo:i::e:r|m:oː::j:ə:r	21
moois	m:oo:is|m:oː:js	14
mooist	m:oo:ist|m:oː:jst	7
mooiste	m:oo:i:st:e:|m:oː:j:st:ə:	63
moor	m:oo:r|m:oː:r	26
mootjes	m:oo:t:j:e:s|m:oː:t:j:ə:s	4
mop	m:o:p|m:ɔ:p	60
moppen	m:o:p:p:e:n|m:ɔ::p:ə:	11
mopperen	m:o:p:p:e::r:e:n|m:ɔ::p:ə::r:ə:	4
mopperend	m:o:p:p:e::r:e:nd|m:ɔ::p:ə::r:ə:nt	2
moppert	m:o:p:p:e:rt|m:ɔ::p:ə:rt	22
morgen	m:o:r:g:e:n|m:ɔ:r:ɣ:ə:	141
morgens	m:o:r:g:e:ns|m:ɔ:r:ɣ:ə:ns	2
mos	m:o:s|m:ɔ:s	54
mossel	m:o:s:s:e:l|m:ɔ::s:ə:l	2
mot	m:o:t|m:ɔ:t	11
motor	m:o::t:o:r|m:oː::t:ɔ:r	16
mouw	m:ou:w|m:ɑu:w	16
mouwen	m:ou::w:e:n|m:ɑu::w:ə:	2
mug	m:u:g|m:ʉ:ç	20
muggen	m:u:g:g:e:n|m:ʉ::ɣ:ə:	13
muil	m:ui:l|m:œy:l	2
muis	m:ui:s|m:œy:s	222
muisje	m:ui:s:j:e:|m:œy:s:j:ə:	62
muisjes	m:ui:s:j:e:s|m:œy:s:j:ə:s	6
muisstil	m:ui:s:st:i:l|m:œy::st:ɪ:l	2
muizen	m:ui::z:e:n|m:œy::z:ə:	41
munt	m:u:nt|m:ʉ:nt	14
munten	m:u:n:t:e:n|m:ʉ:n:t:ə:	16
muren	m:u::r:e:n|m:yː::r:ə:	16
mus	m:u:s|m:ʉ:s	207
museum	m:u::s:e:::u:m|m:yː::s:eː::j:ʉ:m	34
museums	m:u::s:e:::u:ms|m:yː::s:eː::j:ʉ:ms	3
musje	m:u:s:j:e:|m:ʉ:s:j:ə:	6
musjes	m:u:s:j:e:s|m:ʉ:s:j:ə:s	12
mussen	m:u:s:s:e:n|m:ʉ::s:ə:	7
muts	m:u:ts|m:ʉ:ts	58
mutsen	m:u:t:s:e:n|m:ʉ:t:s:ə:	3
muur	m:uu:r|m:yː:r	68
muurtje	m:uu:r:tj:e:|m:yː:r:tj:ə:	9
muziek	m:u::z:ie:k|m:yː::z:iː:k	78
muzikant	m:u::z:i::k:a:nt|m:yː::z:iː::k:ɑ:nt	14
n	n::|:ɛ:n	338
na	n:a:|n:aː:	394
naad	n:aa:d|n:aː:t	3
naai	n:aa:i|n:aː:j	9
naaidoos	n:aa:i:d:oo:s|n:aː:j:d:oː:s	2
naaien	n:aa:i::e:n|n:aː::j:ə:	4
naait	n:aa:it|n:aː:jt	2
naald	n:aa:ld|n:aː:lt	14
naam	n:aa:m|n:aː:m	173
naar	n:aa:r|n:aː:r	3880
naarste	n:aa:r:st:e:|n:aː:r:st:ə:	2
naast	n:aa:st|n:aː:st	218
nacht	n:a:cht|n:ɑ:çt	154
nachtpon	n:a:cht:p:o:n|n:ɑ:çt:p:ɔ:n	2
nachts	n:a:chts|n:ɑ:çts	4
nachtzoen	n:a:cht:z:oe:n|n:ɑ:çt:s:uː:n	3
nadat	n:a::d:a:t|n:aː::d:ɑ:t	2
nadeel	n:a::d:ee:l|n:aː::d:eː:l	4
nadenken	n:a::d:e:n:k:e:n|n:aː::d:ɛ:ŋ:k:ə:	6
nagedacht	n:a::g:e::d:a:cht|n:aː::ɣ:ə::d:ɑ:çt	2
nagel	n:a::g:e:l|n:aː::ɣ:ə:l	23
nagellak	n:a::g:e:l:l:a:k|n:aː::ɣ:ə::l:ɑ:k	2
nagels	n:a::g:e:ls|n:aː::ɣ:ə:ls	21
nam	n:a:m|n:ɑ:m	56
namelijk	n:a::m:e::l:ij:k|n:aː::m:ə::l:ə:k	6
namen	n:a::m:e:n|n:aː::m:ə:	20
nare	n:a::r:e:|n:aː::r:ə:	9
nat	n:a:t|n:ɑ:t	147
natte	n:a:t:t:e:|n:ɑ::t:ə:	26
natuur	n:a::t:uu:r|n:aː::t:yː:r	11
natuurlijk	n:a::t:uu:r:l:ij:k|n:aː::t:yː:r:l:ə:k	73
nauw	n:au:w|n:ɑu:w	12
navel	n:a::v:e:l|n:aː::v:ə:l	7
nectar	n:e:c:t:a:r|n:ɛ:k:t:ɑ:r	6
nederland	n:e::d:e:r:l:a:nd|n:eː::d:ə:r:l:ɑ:nt	6
nederlands	n:e::d:e:r:l:a:nds|n:eː::d:ə:r:l:ɑ:nts	6
nee	n:ee:|n:eː:	984
neef	n:ee:f|n:eː:f	9
neem	n:ee:m|n:eː:m	289
neemt	n:ee:mt|n:eː:mt	236
neer	n:ee:r|n:eː:r	158
neergelegd	n:ee:r:g:e::l:e:gd|n:eː:r:ɣ:ə::l:ɛ:çt	3
neerkomt	n:ee:r:k:o:mt|n:eː:r:k:ɔ:mt	2
negen	n:e::g:e:n|n:eː::ɣ:ə:	17
nek	n:e:k|n:ɛ:k	68
nel	n:e:l|n:ɛ:l	17
nemen	n:e::m:e:n|n:eː::m:ə:	47
nep	n:e:p|n:ɛ:p	12
nergens	n:e:r:g:e:ns|n:ɛ:r:ɣ:ə:ns	36
nest	n:e:st|n:ɛ:st	126
nesten	n:e:s:t:e:n|n:ɛ:s:t:ə:	3
nestje	n:e:st:j:e:|n:ɛ:st:j:ə:	3
net	n:e:t|n:ɛ:t	556
netjes	n:e:t:j:e:s|n:ɛ:t:j:ə:s	22
nette	n:e:t:t:e:|n:ɛ::t:ə:	4
neus	n:eu:s|n:øː:s	319
neushoorn	n:eu:s:h:oo:rn|n:øː:s:h:oː:rn	73
neusje	n:eu:s:j:e:|n:øː:s:j:ə:	5
neuzen	n:eu::z:e:n|n:øː::z:ə:	7
nicht	n:i:cht|n:ɪ:çt	9
nichtje	n:i:cht:j:e:|n:ɪ:çt:j:ə:	3
niemand	n:ie::m:a:nd|n:iː::m:ɑ:nt	128
nies	n:ie:s|n:iː:s	12
niest	n:ie:st|n:iː:st	5
niet	n:ie:t|n:iː:t	4677
niets	n:ie:ts|n:iː:ts	290
nietwaar	n:ie:t:w:aa:r|n:iː:d:w:aː:r	2
nieuw	n:ie:uw|n:iː:w	107
nieuwe	n:ie:uw::e:|n:iː::w:ə:	144
nieuwjaar	n:ie:uw:j:aa:r|n:iː:w:j:aː:r	8
nieuws	n:ie:uws|n:iː:ws	46
nieuwsgierig	n:ie:uws:g:ie::r:i:g|n:iː:ws:ç:iː::r:ə:ç	18
niezen	n:ie::z:e:n|n:iː::z:ə:	3
nijdig	n:ij::d:i:g|n:ɛi::d:ə:ç	6
nijlpaard	n:ij:l:p:aa:rd|n:ɛi:l:p:aː:rt	7
nik	n:i:k|n:ɪ:k	51
niks	n:i:ks|n:ɪ:ks	304
nodig	n:o::d:i:g|n:oː::d:ə:ç	65
noem	n:oe:m|n:uː:m	34
noemde	n:oe:m:d:e:|n:uː:m:d:ə:	2
noemen	n:oe::m:e:n|n:uː::m:ə:	14
noemt	n:oe:mt|n:uː:mt	18
nog	n:o:g|n:ɔ:ç	1919
nogal	n:o:g::a:l|n:ɔ:ç::ɑ:l	13
nok	n:o:k|n:ɔ:k	4
nood	n:oo:d|n:oː:t	11
noodweer	n:oo:d:w:ee:r|n:oː:d:w:eː:r	3
nooit	n:oo:it|n:oː:jt	259
noor	n:oo:r|n:oː:r	295
noord	n:oo:rd|n:oː:rt	5
noorden	n:oo:r:d:e:n|n:oː:r:d:ə:	7
noordpool	n:oo:rd:p:oo:l|n:oː:rt:p:oː:l	12
noordzee	n:oo:rd:z:ee:|n:oː:rt:s:eː:	2
noors	n:oo:rs|n:oː:rs	9
noot	n:oo:t|n:oː:t	121
nootjes	n:oo:t:j:e:s|n:oː:t:j:ə:s	6
normaal	n:o:r:m:aa:l|n:ɔ:r:m:aː:l	9
nors	n:o:rs|n:ɔ:rs	2
noteboom	n:o::t:e::b:oo:m|n:oː::t:ə::b:oː:m	4
noten	n:o::t:e:n|n:oː::t:ə:	13
nou	n:ou:|n:ɑu:	645
nu	n:u:|n:yː:	1264
nul	n:u:l|n:ʉ:l	20
nummer	n:u:m:m:e:r|n:ʉ::m:ə:r	45
nummers	n:u:m:m:e:rs|n:ʉ::m:ə:rs	6
o	:o:|:oː:	274
ober	:o::b:e:r|:oː::b:ə:r	3
och	:o:ch|:ɔ:ç	23
ochtend	:o:ch:t:e:nd|:ɔ:ç:t:ə:nt	20
oef	:oe:f|:uː:f	10
oefen	:oe::f:e:n|:uː::f:ə:	8
oefenen	:oe::f:e::n:e:n|:uː::f:ə::n:ə:	15
oefent	:oe::f:e:nt|:uː::f:ə:nt	9
oehoe	:oe::h:oe:|:uː::h:uː:	3
oei	:oe:i|:uː:j	49
oen	:oe:n|:uː:n	115
oerwoud	:oe:r:w:ou:d|:uː:r:w:ɑu:t	34
oever	:oe::v:e:r|:uː::v:ə:r	4
of	:o:f|:ɔ:f	958
ogen	:o::g:e:n|:oː::ɣ:ə:	188
olie	:o::l:ie:|:oː::l:iː:	9
oliebollen	:o::l:ie::b:o:l:l:e:n|:oː::l:iː::b:ɔ::l:ə:	7
olifant	:o::l:i::f:a:nt|:oː::l:iː::f:ɑ:nt	90
om	:o:m|:ɔ:m	963
oma	:o::m:a:|:oː::m:aː:	474
omdat	:o:m:d:a:t|:ɔ:m:d:ɑ:t	109
omdoen	:o:m:d:oe:n|:ɔ:m:d:uː:n	2
omdraait	:o:m:dr:aa:it|:ɔ:m:dr:aː:jt	2
omgaan	:o:m:g:aa:n|:ɔ:m:ɣ:aː:n	2
omgekeerd	:o:m:g:e::k:ee:rd|:ɔ:m:ɣ:ə::k:eː:rt	2
omheen	:o:m:h:ee:n|:ɔ:m:h:eː:n	4
omhoog	:o:m:h:oo:g|:ɔ:m:h:oː:ç	150
omlaag	:o:m:l:aa:g|:ɔ:m:l:aː:ç	29
omroepen	:o:m:r:oe::p:e:n|:ɔ:m:r:uː::p:ə:	2
omver	:o:m:v:e:r|:ɔ:m:v:ɛ:r	3
omzagen	:o:m:z:a::g:e:n|:ɔ:m:z:aː::ɣ:ə:	3
onaardig	:o:n::aa:r:d:i:g|:ɔ:n::aː:r:d:ə:ç	4
onbekend	:o:n:b:e::k:e:nd|:ɔ:m:b:ə::k:ɛ:nt	5
onbeleefd	:o:n:b:e::l:ee:fd|:ɔ:m:b:ə::l:eː:ft	8
onbewolkt	:o:n:b:e::w:o:lkt|:ɔ:m:b:ə::w:ɔ:lkt	2
onder	:o:n:d:e:r|:ɔ:n:d:ə:r	241
onderaan	:o:n:d:e:r::aa:n|:ɔ:n:d:ə:r::aː:n	4
onderbroek	:o:n:d:e:r:br:oe:k|:ɔ:n:d:ə:r:br:uː:k	2
onderdoor	:o:n:d:e:r:d:oo:r|:ɔ:n:d:ə:r:d:oː:r	4
onderin	:o:n:d:e:r::i:n|:ɔ:n:d:ə:r::ɪ:n	2
onderkant	:o:n:d:e:r:k:a:nt|:ɔ:n:d:ə:r:k:ɑ:nt	4
onderste	:o:n:d:e:r:st:e:|:ɔ:n:d:ə:rs:t:ə:	6
ondersteboven	:o:n:d:e:r:st:e::b:o::v:e:n|:ɔ:n:d:ə:r:st:ə::b:oː::v:ə:	2
ondertussen	:o:n:d:e:r:t:u:s:s:e:n|:ɔ:n:d:ə:r:t:ʉ::s:ə:	2
onderuit	:o:n:d:e:r::ui:t|:ɔ:n:d:ə:r::œy:t	2
onderweg	:o:n:d:e:r:w:e:g|:ɔ:n:d:ə:r:w:ɛ:ç	17
onderzoek	:o:n:d:e:r:z:oe:k|:ɔ:n:d:ə:r:z:uː:k	2
onderzoeken	:o:n:d:e:r:z:oe::k:e:n|:ɔ:n:d:ə:r:z:uː::k:ə:	2
ondiep	:o:n:d:ie:p|:ɔ:n:d:iː:p	4
oneerlijk	:o:n::ee:r:l:ij:k|:ɔ:n::eː:r:l:ə:k	2
ongeduldig	:o:n:g:e::d:u:l:d:i:g|:ɔ:ŋ:ɣ:ə::d:ʉ:l:d:ə:ç	2
ongelijk	:o:n:g:e::l:ij:k|:ɔ:ŋ:ɣ:ə::l:ɛi:k	2
ongeluk	:o:n:g:e::l:u:k|:ɔ:ŋ:ɣ:ə::l:ʉ:k	11
ongerust	:o:n:g:e::r:u:st|:ɔ:ŋ:ɣ:ə::r:ʉ:st	13
ongeveer	:o:n:g:e::v:ee:r|:ɔ:ŋ:ɣ:ə::v:eː:r	2
ongezond	:o:n:g:e::z:o:nd|:ɔ:ŋ:ɣ:ə::z:ɔ:nt	14
onprettig	:o:n:pr:e:t:t:i:g|:ɔ:m:pr:ɛ::t:ə:ç	4
ons	:o:ns|:ɔ:ns	245
ontbijt	:o:nt:b:ij:t|:ɔ:nd:b:ɛi:t	18
ontbijten	:o:nt:b:ij::t:e:n|:ɔ:nd:b:ɛi::t:ə:	11
ontdekken	:o:nt:d:e:k:k:e:n|:ɔ:n:d:ɛ::k:ə:	7
ontdekt	:o:nt:d:e:kt|:ɔ:n:d:ɛ:kt	9
onthoud	:o:nt:h:ou:d|:ɔ:nt:h:ɑu:t	2
onthouden	:o:nt:h:ou::d:e:n|:ɔ:nt:h:ɑu::d:ə:	12
ontploffen	:o:nt:pl:o:f:f:e:n|:ɔ:nt:pl:ɔ::f:ə:	4
ontsnappen	:o:nt:sn:a:p:p:e:n|:ɔ:nt:sn:ɑ::p:ə:	6
ontsnapt	:o:nt:sn:a:pt|:ɔ:nt:sn:ɑ:pt	6
ontstaan	:o:nt:st:aa:n|:ɔ:nt:st:aː:n	3
ontstaat	:o:nt:st:aa:t|:ɔ:nt:st:aː:t	4
ontvangen	:o:nt:v:a:n:g:e:n|:ɔ:nt:f:ɑ::ŋ:ə:	3
ontwerpen	:o:nt:w:e:r:p:e:n|:ɔ:nt:w:ɛ:r:p:ə:	2
ontzettend	:o:nt:z:e:t:t:e:nd|:ɔ:nt:s:ɛ::t:ə:nt	17
onveilig	:o:n:v:ei::l:i:g|:ɔ:n:v:ɛi::l:ə:ç	7
onweer	:o:n:w:ee:r|:ɔ:n:w:eː:r	12
onze	:o:n:z:e:|:ɔ:n:z:ə:	69
onzichtbaar	:o:n:z:i:cht:b:aa:r|:ɔ:n:z:ɪ:ɣd:b:aː:r	10
onzin	:o:n:z:i:n|:ɔ:n:z:ɪ:n	6
oog	:oo:g|:oː:ç	128
oogjes	:oo:g:j:e:s|:oː:ç:j:ə:s	13
ooglap	:oo:g:l:a:p|:oː:ɣ:l:ɑ:p	7
ooi	:oo:i|:oː:j	4
ooit	:oo:it|:oː:jt	20
ook	:oo:k|:oː:k	2574
oom	:oo:m|:oː:m	328
ooms	:oo:ms|:oː:ms	9
oor	:oo:r|:oː:r	136
oorbel	:oo:r:b:e:l|:oː:r:b:ɛ:l	7
oorlog	:oo:r:l:o:g|:oː:r:l:ɔ:ç	10
oost	:oo:st|:oː:st	3
op	:o:p|:ɔ:p	5608
opa	:o::p:a:|:oː::p:aː:	399
opbellen	:o:p:b:e:l:l:e:n|:ɔ::b:ɛ::l:ə:	2
opblijven	:o:p:bl:ij::v:e:n|:ɔ::bl:ɛi::v:ə:	2
opdracht	:o:p:dr:a:cht|:ɔ:b:dr:ɑ:çt	3
opdrachten	:o:p:dr:a:ch:t:e:n|:ɔ:b:dr:ɑ:ç:t:ə:	2
opeens	:o:p::ee:ns|:ɔ:p::eː:ns	115
open	:o::p:e:n|:oː::p:ə:	301
openbaar	:o::p:e:n:b:aa:r|:oː::p:ə::b:aː:r	4
opendoet	:o::p:e:n:d:oe:t|:oː::p:ə::d:uː:t	3
openmaken	:o::p:e:n:m:a::k:e:n|:oː::p:ə::m:aː::k:ə:	2
opent	:o::p:e:nt|:oː::p:ə:nt	15
opeten	:o:p::e::t:e:n|:ɔ:p::eː::t:ə:	8
opgelost	:o:p:g:e::l:o:st|:ɔ:p:ç:ə::l:ɔ:st	2
opgelucht	:o:p:g:e::l:u:cht|:ɔ:p:ç:ə::l:ʉ:çt	5
opgetild	:o:p:g:e::t:i:ld|:ɔ:p:ç:ə::t:ɪ:lt	3
opgeven	:o:p:g:e::v:e:n|:ɔ:p:ç:eː::v:ə:	5
opgewekt	:o:p:g:e::w:e:kt|:ɔ:p:ç:ə::w:ɛ:kt	4
opgewonden	:o:p:g:e::w:o:n:d:e:n|:ɔ:p:ç:ə::w:ɔ:n:d:ə:	4
opgezet	:o:p:g:e::z:e:t|:ɔ:p:ç:ə::z:ɛ:t	2
ophalen	:o:p:h:a::l:e:n|:ɔ:p:h:aː::l:ə:	13
ophangen	:o:p:h:a:n:g:e:n|:ɔ:p:h:ɑ::ŋ:ə:	8
ophouden	:o:p:h:ou::d:e:n|:ɔ:p:h:ɑu::d:ə:	5
ophoudt	:o:p:h:ou:dt|:ɔ:p:h:ɑu:t	2
opkijken	:o:p:k:ij::k:e:n|:ɔ:p:k:ɛi::k:ə:	13
opkomt	:o:p:k:o:mt|:ɔ:p:k:ɔ:mt	2
opletten	:o:p:l:e:t:t:e:n|:ɔ:p:l:ɛ::t:ə:	3
oplossen	:o:p:l:o:s:s:e:n|:ɔ:p:l:ɔ::s:ə:	8
oplossing	:o:p:l:o:s:s:i:ng|:ɔ:p:l:ɔ::s:ɪ:ŋ	5
opluchting	:o:p:l:u:ch:t:i:ng|:ɔ:p:l:ʉ:ç:t:ɪ:ŋ	2
opnieuw	:o:p:n:ie:uw|:ɔ:p:n:iː:w	33
opnoemen	:o:p:n:oe::m:e:n|:ɔ:p:n:uː::m:ə:	5
oppakken	:o:p:p:a:k:k:e:n|:ɔ::p:ɑ::k:ə:	2
oppas	:o:p:p:a:s|:ɔ::p:ɑ:s	6
opruimen	:o:p:r:ui::m:e:n|:ɔ:p:r:œy::m:ə:	5
opruimt	:o:p:r:ui:mt|:ɔ:p:r:œy:mt	3
opschepper	:o:p:sch:e:p:p:e:r|:ɔ:p:sç:ɛ::p:ə:r	8
opschieten	:o:p:sch:ie::t:e:n|:ɔ:p:sç:iː::t:ə:	7
opschrijven	:o:p:schr:ij::v:e:n|:ɔ:p:sçr:ɛi::v:ə:	4
opstaan	:o:p:st:aa:n|:ɔ:p:st:aː:n	11
optillen	:o:p:t:i:l:l:e:n|:ɔ:p:t:ɪ::l:ə:	2
optilt	:o:p:t:i:lt|:ɔ:p:t:ɪ:lt	2
optocht	:o:p:t:o:cht|:ɔ:p:t:ɔ:çt	4
optreden	:o:p:tr:e::d:e:n|:ɔ:p:tr:eː::d:ə:	2
optreedt	:o:p:tr:ee:dt|:ɔ:p:tr:eː:t	2
opvangen	:o:p:v:a:n:g:e:n|:ɔ:p:f:ɑ::ŋ:ə:	2
opzeggen	:o:p:z:e:g:g:e:n|:ɔ:p:s:ɛ::ɣ:ə:	2
opzij	:o:p:z:ij:|:ɔ:p:s:ɛi:	34
opzoeken	:o:p:z:oe::k:e:n|:ɔ:p:s:uː::k:ə:	5
oranje	:o::r:a:n:j:e:|:oː::r:ɑ:n:j:ə:	7
orde	:o:r:d:e:|:ɔ:r:d:ə:	6
oren	:o::r:e:n|:oː::r:ə:	49
orgel	:o:r:g:e:l|:ɔ:r:ɣ:ə:l	9
orkest	:o:r:k:e:st|:ɔ:r:k:ɛ:st	15
os	:o:s|:ɔ:s	16
otter	:o:t:t:e:r|:ɔ::t:ə:r	28
oud	:ou:d|:ɑu:t	96
oude	:ou::d:e:|:ɑu::d:ə:	87
ouder	:ou::d:e:r|:ɑu::d:ə:r	5
ouders	:ou::d:e:rs|:ɑu::d:ə:rs	38
oudjaar	:ou:d:j:aa:r|:ɑu:t:j:aː:r	13
oudste	:ou:d:st:e:|:ɑu:t:st:ə:	3
ouwe	:ou::w:e:|:ɑu::w:ə:	2
oven	:o::v:e:n|:oː::v:ə:	11
over	:o::v:e:r|:oː::v:ə:r	588
overal	:o::v:e:r::a:l|:oː::v:ə:r::ɑ:l	51
overdag	:o::v:e:r:d:a:g|:oː::v:ə:r:d:ɑ:ç	5
overeind	:o::v:e:r::ei:nd|:oː::v:ə:r::ɛi:nt	11
overheen	:o::v:e:r:h:ee:n|:oː::v:ə:r:h:eː:n	7
overkant	:o::v:e:r:k:a:nt|:oː::v:ə:r:k:ɑ:nt	17
p	p::|p:eː:	367
pa	p:a:|p:aː:	42
paadjes	p:aa:d:j:e:s|p:aː:t:j:ə:s	7
paal	p:aa:l|p:aː:l	33
paaltje	p:aa:l:tj:e:|p:aː:l:tj:ə:	2
paar	p:aa:r|p:aː:r	131
paard	p:aa:rd|p:aː:rt	128
paarden	p:aa:r:d:e:n|p:aː:r:d:ə:	8
paardje	p:aa:rd:j:e:|p:aː:rt:j:ə:	11
paars	p:aa:rs|p:aː:rs	36
paarse	p:aa:r:s:e:|p:aː:r:s:ə:	3
pad	p:a:d|p:ɑ:t	113
paddestoelen	p:a:d:d:e::st:oe::l:e:n|p:ɑ::d:ə::st:uː::l:ə:	2
pagina	p:a::g:i::n:a:|p:aː::ɣ:iː::n:aː:	16
pak	p:a:k|p:ɑ:k	284
pakje	p:a:k:j:e:|p:ɑ:k:j:ə:	46
pakjes	p:a:k:j:e:s|p:ɑ:k:j:ə:s	5
pakken	p:a:k:k:e:n|p:ɑ::k:ə:	75
pakt	p:a:kt|p:ɑ:kt	527
pakte	p:a:k:t:e:|p:ɑ:k:t:ə:	12
pal	p:a:l|p:ɑ:l	5
paleis	p:a::l:ei:s|p:aː::l:ɛi:s	24
palen	p:a::l:e:n|p:aː::l:ə:	9
palm	p:a:lm|p:ɑ:lm	8
palmboom	p:a:lm:b:oo:m|p:ɑ:lm:b:oː:m	3
pan	p:a:n|p:ɑ:n	121
panda	p:a:n:d:a:|p:ɑ:n:d:aː:	12
pang	p:a:ng|p:ɑ:ŋ	2
paniek	p:a::n:ie:k|p:aː::n:iː:k	5
pannen	p:a:n:n:e:n|p:ɑ::n:ə:	9
pannetje	p:a:n:n:e::tj:e:|p:ɑ::n:ə::tj:ə:	6
panter	p:a:n:t:e:r|p:ɑ:n:t:ə:r	3
pap	p:a:p|p:ɑ:p	409
papa	p:a::p:a:|p:ɑ::p:aː:	608
papegaai	p:a::p:e::g:aa:i|p:ɑ::p:ə::ɣ:aː:j	48
paperclip	p:a::p:e:r:cl:i:p|p:eː::p:ə:r:kl:ɪ:p	2
paperclips	p:a::p:e:r:cl:i:ps|p:eː::p:ə:r:kl:ɪ:ps	3
papier	p:a::p:ie:r|p:aː::p:iː:r	94
papierbak	p:a::p:ie:r:b:a:k|p:aː::p:iː:r:b:ɑ:k	2
papieren	p:a::p:ie::r:e:n|p:aː::p:iː::r:ə:	6
papiertje	p:a::p:ie:r:tj:e:|p:aː::p:iː:r:tj:ə:	10
paprika	p:a::pr:i::k:a:|p:ɑ::pr:iː::k:aː:	2
paps	p:a:ps|p:ɑ:ps	11
paraplu	p:a::r:a::pl:u:|p:aː::r:aː::pl:yː:	9
parasol	p:a::r:a::s:o:l|p:aː::r:aː::s:ɔ:l	5
pardon	p:a:r:d:o:n|p:ɑ:r:d:ɔ:n	2
parel	p:a::r:e:l|p:aː::r:ə:l	14
parels	p:a::r:e:ls|p:aː::r:ə:ls	7
paren	p:a::r:e:n|p:aː::r:ə:	4
parfum	p:a:r:f:u:m|p:ɑ:r:f:ʉ:m	4
parijs	p:a::r:ij:s|p:aː::r:ɛi:s	3
park	p:a:rk|p:ɑ:rk	93
parkeerplaats	p:a:r:k:ee:r:pl:aa:ts|p:ɑ:r:k:eː:r:pl:aː:ts	3
partjes	p:a:rt:j:e:s|p:ɑ:rt:j:ə:s	2
pas	p:a:s|p:ɑ:s	245
paspoort	p:a:s:p:oo:rt|p:ɑ:s:p:oː:rt	3
passen	p:a:s:s:e:n|p:ɑ::s:ə:	26
past	p:a:st|p:ɑ:st	89
pasten	p:a:s:t:e:n|p:ɑ:s:t:ə:	3
patat	p:a::t:a:t|p:aː::t:ɑ:t	4
patrijs	p:a::tr:ij:s|p:ɑ::tr:ɛi:s	3
pats	p:a:ts|p:ɑ:ts	21
paus	p:au:s|p:ɑu:s	4
pauw	p:au:w|p:ɑu:w	146
pauwen	p:au::w:e:n|p:ɑu::w:ə:	5
pauze	p:au::z:e:|p:ɑu::z:ə:	13
pech	p:e:ch|p:ɛ:ç	31
peen	p:ee:n|p:eː:n	48
peer	p:ee:r|p:eː:r	209
peet	p:ee:t|p:eː:t	2
peinzend	p:ei:n:z:e:nd|p:ɛi:n:z:ə:nt	2
pel	p:e:l|p:ɛ:l	6
pels	p:e:ls|p:ɛ:ls	2
pen	p:e:n|p:ɛ:n	224
pennen	p:e:n:n:e:n|p:ɛ::n:ə:	14
penseel	p:e:n:s:ee:l|p:ɛ:n:s:eː:l	4
pep	p:e:p|p:ɛ:p	48
peper	p:e::p:e:r|p:eː::p:ə:r	3
per	p:e:r|p:ɛ:r	22
peren	p:e::r:e:n|p:eː::r:ə:	3
perron	p:e:r:r:o:n|p:ɛ::r:ɔ:n	6
pers	p:e:rs|p:ɛ:rs	5
perst	p:e:rst|p:ɛ:rst	12
pest	p:e:st|p:ɛ:st	8
pesten	p:e:s:t:e:n|p:ɛ:s:t:ə:	11
pesterig	p:e:s:t:e::r:i:g|p:ɛ:s:t:ə::r:ə:ç	2
pet	p:e:t|p:ɛ:t	217
peter	p:e::t:e:r|p:eː::t:ə:r	282
peters	p:e::t:e:rs|p:eː::t:ə:rs	7
pets	p:e:ts|p:ɛ:ts	11
petten	p:e:t:t:e:n|p:ɛ::t:ə:	17
peuk	p:eu:k|p:øː:k	18
peuter	p:eu::t:e:r|p:øː::t:ə:r	3
pi	p:i:|p:iː:	3
piano	p:i:::a::n:o:|p:iː::j:aː::n:oː:	8
piek	p:ie:k|p:iː:k	2
piekert	p:ie::k:e:rt|p:iː::k:ə:rt	5
piep	p:ie:p|p:iː:p	43
piepen	p:ie::p:e:n|p:iː::p:ə:	11
piepklein	p:ie:p:kl:ei:n|p:iː:p:kl:ɛi:n	9
piept	p:ie:pt|p:iː:pt	55
piepte	p:ie:p:t:e:|p:iː:p:t:ə:	2
pier	p:ie:r|p:iː:r	23
piet	p:ie:t|p:iː:t	277
pijl	p:ij:l|p:ɛi:l	48
pijn	p:ij:n|p:ɛi:n	149
pijnlijk	p:ij:n:l:ij:k|p:ɛi:n:l:ə:k	8
pijp	p:ij:p|p:ɛi:p	29
pik	p:i:k|p:ɪ:k	25
pikdonker	p:i:k:d:o:n:k:e:r|p:ɪ:ɡ:d:ɔ:ŋ:k:ə:r	3
pikken	p:i:k:k:e:n|p:ɪ::k:ə:	7
pikt	p:i:kt|p:ɪ:kt	24
pikten	p:i:k:t:e:n|p:ɪ:k:t:ə:	2
pikzwart	p:i:k:zw:a:rt|p:ɪ:k:sw:ɑ:rt	3
pil	p:i:l|p:ɪ:l	42
pillen	p:i:l:l:e:n|p:ɪ::l:ə:	10
piloot	p:i::l:oo:t|p:iː::l:oː:t	27
pin	p:i:n|p:ɪ:n	24
pinda	p:i:n:d:a:|p:ɪ:n:d:aː:	5
pindakaas	p:i:n:d:a::k:aa:s|p:ɪ:n:d:aː::k:aː:s	6
pink	p:i:nk|p:ɪ:ŋk	24
pinnen	p:i:n:n:e:n|p:ɪ::n:ə:	5
pinnetje	p:i:n:n:e::tj:e:|p:ɪ::n:ə::tj:ə:	2
pion	p:i:::o:n|p:iː::j:ɔ:n	2
pionnen	p:i:::o:n:n:e:n|p:iː::j:ɔ::n:ə:	2
pip	p:i:p|p:ɪ:p	54
pips	p:i:ps|p:ɪ:ps	4
piraat	p:i::r:aa:t|p:iː::r:aː:t	54
piraten	p:i::r:a::t:e:n|p:iː::r:aː::t:ə:	20
piratenschip	p:i::r:a::t:e:n:sch:i:p|p:iː::r:aː::t:ə::sç:ɪ:p	2
pissebed	p:i:s:s:e::b:e:d|p:ɪ::s:ə::b:ɛ:t	3
piste	p:i:s:t:e:|p:iː:s:t:ə:	4
piste	p:i:s:t:e:|p:ɪ:s:t:ə:	4
pistool	p:i:s:t:oo:l|p:iː:s:t:oː:l	3
pit	p:i:t|p:ɪ:t	63
pitjes	p:i:t:j:e:s|p:ɪ:t:j:ə:s	3
pizza	p:i:z:z:a:|p:iː::ts:aː:	14
plaag	pl:aa:g|pl:aː:ç	4
plaagt	pl:aa:gt|pl:aː:çt	10
plaat	pl:aa:t|pl:aː:t	22
plaatje	pl:aa:t:j:e:|pl:aː:t:j:ə:	54
plaatjes	pl:aa:t:j:e:s|pl:aː:t:j:ə:s	68
plaats	pl:aa:ts|pl:aː:ts	43
plafond	pl:a::f:o:nd|pl:aː::f:ɔ:nt	6
plagen	pl:a::g:e:n|pl:aː::ɣ:ə:	16
plak	pl:a:k|pl:ɑ:k	27
plakband	pl:a:k:b:a:nd|pl:ɑ:ɡ:b:ɑ:nt	4
plakboek	pl:a:k:b:oe:k|pl:ɑ:ɡ:b:uː:k	17
plakjes	pl:a:k:j:e:s|pl:ɑ:k:j:ə:s	6
plakken	pl:a:k:k:e:n|pl:ɑ::k:ə:	12
plaksel	pl:a:k:s:e:l|pl:ɑ:k:s:ə:l	5
plakt	pl:a:kt|pl:ɑ:kt	29
plan	pl:a:n|pl:ɑ:n	154
plan	pl:a:n|pl:ɛ:n	154
plank	pl:a:nk|pl:ɑ:ŋk	39
planken	pl:a:n:k:e:n|pl:ɑ:ŋ:k:ə:	5
plankje	pl:a:nk:j:e:|pl:ɑ:ŋk:j:ə:	11
plannetje	pl:a:n:n:e::tj:e:|pl:ɑ::n:ə::tj:ə:	6
plant	pl:a:nt|pl:ɑ:nt	33
plant	pl:a:nt|pl:ɛ:nt	33
planten	pl:a:n:t:e:n|pl:ɑ:n:t:ə:	42
plantje	pl:a:nt:j:e:|pl:ɑ:nt:j:ə:	7
plantjes	pl:a:nt:j:e:s|pl:ɑ:nt:j:ə:s	5
plas	pl:a:s|pl:ɑ:s	42
plasje	pl:a:s:j:e:|pl:ɑ:s:j:ə:	2
plassen	pl:a:s:s:e:n|pl:ɑ::s:ə:	18
plast	pl:a:st|pl:ɑ:st	3
plastic	pl:a:s:t:i:c|pl:ɛ:s:t:ɪ:k	17
plat	pl:a:t|pl:ɑ:t	18
platte	pl:a:t:t:e:|pl:ɑ::t:ə:	7
plechtig	pl:e:ch:t:i:g|pl:ɛ:ç:t:ə:ç	5
plein	pl:ei:n|pl:ɛi:n	50
pleintje	pl:ei:n:tj:e:|pl:ɛi:n:tj:ə:	15
pleister	pl:ei:s:t:e:r|pl:ɛi:s:t:ə:r	12
pleisters	pl:ei:s:t:e:rs|pl:ɛi:s:t:ə:rs	2
plek	pl:e:k|pl:ɛ:k	85
plekjes	pl:e:k:j:e:s|pl:ɛ:k:j:ə:s	4
plekken	pl:e:k:k:e:n|pl:ɛ::k:ə:	6
plezier	pl:e::z:ie:r|pl:ə::z:iː:r	27
plicht	pl:i:cht|pl:ɪ:çt	2
ploeteren	pl:oe::t:e::r:e:n|pl:uː::t:ə::r:ə:	2
plof	pl:o:f|pl:ɔ:f	18
ploffen	pl:o:f:f:e:n|pl:ɔ::f:ə:	2
ploft	pl:o:ft|pl:ɔ:ft	23
plons	pl:o:ns|pl:ɔ:ns	14
plooi	pl:oo:i|pl:oː:j	4
plooit	pl:oo:it|pl:oː:jt	3
plop	pl:o:p|pl:ɔ:p	2
plots	pl:o:ts|pl:ɔ:ts	22
plotseling	pl:o:t:s:e::l:i:ng|pl:ɔ:t:s:ə::l:ɪ:ŋ	7
plu	pl:u:|pl:yː:	6
pluim	pl:ui:m|pl:œy:m	12
pluis	pl:ui:s|pl:œy:s	15
pluk	pl:u:k|pl:ʉ:k	13
plukken	pl:u:k:k:e:n|pl:ʉ::k:ə:	10
plukt	pl:u:kt|pl:ʉ:kt	19
plus	pl:u:s|pl:ʉ:s	3
po	p:o:|p:oː:	3
podium	p:o::d:i:::u:m|p:oː::d:iː::j:ʉ:m	18
poe	p:oe:|p:uː:	51
poedel	p:oe::d:e:l|p:uː::d:ə:l	3
poeder	p:oe::d:e:r|p:uː::d:ə:r	4
poederdoos	p:oe::d:e:r:d:oo:s|p:uː::d:ə:r:d:oː:s	2
poef	p:oe:f|p:uː:f	4
poeh	p:oe:h|p:uː:	13
poel	p:oe:l|p:uː:l	4
poen	p:oe:n|p:uː:n	19
poep	p:oe:p|p:uː:p	11
poept	p:oe:pt|p:uː:pt	3
poes	p:oe:s|p:uː:s	450
poesje	p:oe:s:j:e:|p:uː:s:j:ə:	13
poesjes	p:oe:s:j:e:s|p:uː:s:j:ə:s	9
poets	p:oe:ts|p:uː:ts	6
poetsdoek	p:oe:ts:d:oe:k|p:uː:dz:d:uː:k	3
poetsen	p:oe:t:s:e:n|p:uː:t:s:ə:	5
poetst	p:oe:tst|p:uː:tst	12
poezen	p:oe::z:e:n|p:uː::z:ə:	11
pok	p:o:k|p:ɔ:k	8
polder	p:o:l:d:e:r|p:ɔ:l:d:ə:r	5
politie	p:o::l:i::t:ie:|p:oː::l:iː::ts:iː:	15
politieagent	p:o::l:i::t:ie:::a::g:e:nt|p:oː::l:iː::ts:iː:::aː::ɣ:ɛ:nt	2
pols	p:o:ls|p:ɔ:ls	5
pomp	p:o:mp|p:ɔ:mp	5
pon	p:o:n|p:ɔ:n	53
pond	p:o:nd|p:ɔ:nt	7
pont	p:o:nt|p:ɔ:nt	9
pony	p:o::n:y:|p:ɔ::n:iː:	8
pook	p:oo:k|p:oː:k	3
pool	p:oo:l|p:oː:l	3
pool	p:oo:l|p:uː:l	3
poort	p:oo:rt|p:oː:rt	23
poos	p:oo:s|p:oː:s	43
poosje	p:oo:s:j:e:|p:oː:s:j:ə:	20
poot	p:oo:t|p:oː:t	207
pootje	p:oo:t:j:e:|p:oː:t:j:ə:	6
pootjes	p:oo:t:j:e:s|p:oː:t:j:ə:s	42
pop	p:o:p|p:ɔ:p	109
popje	p:o:p:j:e:|p:ɔ:p:j:ə:	6
popmuziek	p:o:p:m:u::z:ie:k|p:ɔ:p:m:yː::z:iː:k	3
poppen	p:o:p:p:e:n|p:ɔ::p:ə:	9
poppenhuis	p:o:p:p:e:n:h:ui:s|p:ɔ::p:ə::h:œy:s	4
poppenkast	p:o:p:p:e:n:k:a:st|p:ɔ::p:ə::k:ɑ:st	4
poppetjes	p:o:p:p:e::tj:e:s|p:ɔ::p:ə::tj:ə:s	4
por	p:o:r|p:ɔ:r	6
port	p:o:rt|p:ɔ:rt	3
portemonnee	p:o:r:t:e::m:o:n:n:ee:|p:ɔ:r:t:ə::m:ɔ::n:eː:	3
post	p:o:st|p:ɔ:st	40
postbode	p:o:st:b:o::d:e:|p:ɔ:zd:b:oː::d:ə:	2
postduif	p:o:st:d:ui:f|p:ɔ:z:d:œy:f	5
poster	p:o:s:t:e:r|p:oː:s:t:ə:r	5
poster	p:o:s:t:e:r|p:ɔ:s:t:ə:r	5
postzegel	p:o:st:z:e::g:e:l|p:ɔ:st:s:eː::ɣ:ə:l	3
postzegels	p:o:st:z:e::g:e:ls|p:ɔ:st:s:eː::ɣ:ə:ls	2
pot	p:o:t|p:ɔ:t	87
poten	p:o::t:e:n|p:oː::t:ə:	45
potje	p:o:t:j:e:|p:ɔ:t:j:ə:	16
potjes	p:o:t:j:e:s|p:ɔ:t:j:ə:s	7
potloden	p:o:t:l:o::d:e:n|p:ɔ:t:l:oː::d:ə:	2
potlood	p:o:t:l:oo:d|p:ɔ:t:l:oː:t	14
potten	p:o:t:t:e:n|p:ɔ::t:ə:	4
praat	pr:aa:t|pr:aː:t	75
praatje	pr:aa:t:j:e:|pr:aː:t:j:ə:	2
praatjes	pr:aa:t:j:e:s|pr:aː:t:j:ə:s	4
pracht	pr:a:cht|pr:ɑ:çt	3
prachtig	pr:a:ch:t:i:g|pr:ɑ:ç:t:ə:ç	42
prachtige	pr:a:ch:t:i::g:e:|pr:ɑ:ç:t:ə::ɣ:ə:	23
prak	pr:a:k|pr:ɑ:k	3
praten	pr:a::t:e:n|pr:aː::t:ə:	58
precies	pr:e::c:ie:s|pr:ə::s:iː:s	59
prei	pr:ei:|pr:ɛi:	16
pret	pr:e:t|pr:ɛ:t	15
pretje	pr:e:t:j:e:|pr:ɛ:t:j:ə:	3
pretpark	pr:e:t:p:a:rk|pr:ɛ:t:p:ɑ:rk	9
prettig	pr:e:t:t:i:g|pr:ɛ::t:ə:ç	3
prijs	pr:ij:s|pr:ɛi:s	32
prik	pr:i:k|pr:ɪ:k	20
prikbord	pr:i:k:b:o:rd|pr:ɪ:ɡ:b:ɔ:rt	2
prikken	pr:i:k:k:e:n|pr:ɪ::k:ə:	6
prikker	pr:i:k:k:e:r|pr:ɪ::k:ə:r	3
prikt	pr:i:kt|pr:ɪ:kt	17
prikte	pr:i:k:t:e:|pr:ɪ:k:t:ə:	2
prima	pr:i::m:a:|pr:iː::m:aː:	16
prins	pr:i:ns|pr:ɪ:ns	122
prinsen	pr:i:n:s:e:n|pr:ɪ:n:s:ə:	3
prinses	pr:i:n:s:e:s|pr:ɪ:n:s:ɛ:s	98
prinsesje	pr:i:n:s:e:s:j:e:|pr:ɪ:n:s:ɛ:s:j:ə:	3
prinsessen	pr:i:n:s:e:s:s:e:n|pr:ɪ:n:s:ɛ::s:ə:	6
pro	pr:o:|pr:oː:	3
probeer	pr:o::b:ee:r|pr:oː::b:eː:r	14
probeerde	pr:o::b:ee:r:d:e:|pr:oː::b:eː:r:d:ə:	4
probeert	pr:o::b:ee:rt|pr:oː::b:eː:rt	29
proberen	pr:o::b:e::r:e:n|pr:oː::b:eː::r:ə:	11
probleem	pr:o::bl:ee:m|pr:oː::bl:eː:m	14
problemen	pr:o::bl:e::m:e:n|pr:oː::bl:eː::m:ə:	4
proef	pr:oe:f|pr:uː:f	26
proefje	pr:oe:f:j:e:|pr:uː:f:j:ə:	2
proeft	pr:oe:ft|pr:uː:ft	8
proest	pr:oe:st|pr:uː:st	6
proeven	pr:oe::v:e:n|pr:uː::v:ə:	3
prooi	pr:oo:i|pr:oː:j	33
prop	pr:o:p|pr:ɔ:p	4
propt	pr:o:pt|pr:ɔ:pt	6
propvol	pr:o:p:v:o:l|pr:ɔ:p:f:ɔ:l	2
pruik	pr:ui:k|pr:œy:k	14
pruim	pr:ui:m|pr:œy:m	14
prullenbak	pr:u:l:l:e:n:b:a:k|pr:ʉ::l:ə::b:ɑ:k	4
publiek	p:u::bl:ie:k|p:yː::bl:iː:k	46
pudding	p:u:d:d:i:ng|p:ʉ::d:ɪ:ŋ	6
puf	p:u:f|p:ʉ:f	3
puft	p:u:ft|p:ʉ:ft	15
puilen	p:ui::l:e:n|p:œy::l:ə:	3
puilt	p:ui:lt|p:œy:lt	2
puin	p:ui:n|p:œy:n	5
puist	p:ui:st|p:œy:st	3
puk	p:u:k|p:ʉ:k	27
pukkeltje	p:u:k:k:e:l:tj:e:|p:ʉ::k:ə:l:tj:ə:	2
pulkt	p:u:lkt|p:ʉ:lkt	2
punt	p:u:nt|p:ʉ:nt	42
punten	p:u:n:t:e:n|p:ʉ:n:t:ə:	11
punthoed	p:u:nt:h:oe:d|p:ʉ:nt:h:uː:t	5
puntig	p:u:n:t:i:g|p:ʉ:n:t:ə:ç	3
puntje	p:u:nt:j:e:|p:ʉ:nt:j:ə:	9
puntjes	p:u:nt:j:e:s|p:ʉ:nt:j:ə:s	3
puntmuts	p:u:nt:m:u:ts|p:ʉ:nt:m:ʉ:ts	2
pup	p:u:p|p:ʉ:p	73
pure	p:u::r:e:|p:yː::r:ə:	3
put	p:u:t|p:ʉ:t	45
puur	p:uu:r|p:yː:r	6
puzzel	p:u:z:z:e:l|p:ʉ::z:ə:l	6
pyjama	p:y::j:a::m:a:|p:iː::j:aː::m:aː:	8
r	r::|:ɛ:r	136
ra	r:a:|r:aː:	40
raad	r:aa:d|r:aː:t	19
raadsel	r:aa:d:s:e:l|r:aː:t:s:ə:l	13
raadsels	r:aa:d:s:e:ls|r:aː:t:s:ə:ls	3
raadt	r:aa:dt|r:aː:t	10
raaf	r:aa:f|r:aː:f	31
raak	r:aa:k|r:aː:k	69
raakt	r:aa:kt|r:aː:kt	19
raakte	r:aa:k:t:e:|r:aː:k:t:ə:	3
raakten	r:aa:k:t:e:n|r:aː:k:t:ə:	3
raam	r:aa:m|r:aː:m	393
raampje	r:aa:m:pj:e:|r:aː:m:pj:ə:	14
raap	r:aa:p|r:aː:p	84
raapt	r:aa:pt|r:aː:pt	26
raar	r:aa:r|r:aː:r	335
raas	r:aa:s|r:aː:s	13
raast	r:aa:st|r:aː:st	13
rad	r:a:d|r:ɑ:t	3
raden	r:a::d:e:n|r:aː::d:ə:	14
raden	r:a::d:e:n|r:aː::d:ɛ:n	14
radio	r:a::d:i:::o:|r:aː::d:iː::j:oː:	12
raken	r:a::k:e:n|r:aː::k:ə:	10
raket	r:a::k:e:t|r:aː::k:ɛ:t	40
rakker	r:a:k:k:e:r|r:ɑ::k:ə:r	2
ram	r:a:m|r:ɑ:m	3
ramen	r:a::m:e:n|r:aː::m:ə:	13
rammelaar	r:a:m:m:e::l:aa:r|r:ɑ::m:ə::l:aː:r	3
rammelen	r:a:m:m:e::l:e:n|r:ɑ::m:ə::l:ə:	2
rammelt	r:a:m:m:e:lt|r:ɑ::m:ə:lt	3
ramp	r:a:mp|r:ɑ:mp	11
rand	r:a:nd|r:ɑ:nt	48
randje	r:a:nd:j:e:|r:ɑ:nt:j:ə:	2
rang	r:a:ng|r:ɑ:ŋ	8
rare	r:a::r:e:|r:aː::r:ə:	22
rat	r:a:t|r:ɑ:t	128
rats	r:a:ts|r:ɑ:ts	4
ratten	r:a:t:t:e:n|r:ɑ::t:ə:	6
rauw	r:au:w|r:ɑu:w	22
recept	r:e::c:e:pt|r:ə::s:ɛ:pt	7
recht	r:e:cht|r:ɛ:çt	54
rechtdoor	r:e:cht:d:oo:r|r:ɛ:ɣ:d:oː:r	9
rechte	r:e:ch:t:e:|r:ɛ:ç:t:ə:	9
rechtop	r:e:cht::o:p|r:ɛ:çt::ɔ:p	18
rechts	r:e:chts|r:ɛ:çts	36
rechtsaf	r:e:chts::a:f|r:ɛ:çts::ɑ:f	4
reclame	r:e::cl:a::m:e:|r:ə::kl:aː::m:ə:	5
red	r:e:d|r:ɛ:t	3
redden	r:e:d:d:e:n|r:ɛ::d:ə:	24
reden	r:e::d:e:n|r:eː::d:ə:	3
redt	r:e:dt|r:ɛ:t	4
ree	r:ee:|r:eː:	40
reed	r:ee:d|r:eː:t	7
reep	r:ee:p|r:eː:p	130
regel	r:e::g:e:l|r:eː::ɣ:ə:l	5
regels	r:e::g:e:ls|r:eː::ɣ:ə:ls	8
regelt	r:e::g:e:lt|r:eː::ɣ:ə:lt	3
regen	r:e::g:e:n|r:eː::ɣ:ə:	22
regendruppels	r:e::g:e:n:dr:u:p:p:e:ls|r:eː::ɣ:ə:n:dr:ʉ::p:ə:ls	2
regenen	r:e::g:e::n:e:n|r:eː::ɣ:ə::n:ə:	6
regenjas	r:e::g:e:n:j:a:s|r:eː::ɣ:ə:n:j:ɑ:s	4
regent	r:e::g:e:nt|r:eː::ɣ:ə:nt	16
regent	r:e::g:e:nt|r:ə::ɣ:ɛ:nt	16
reiger	r:ei::g:e:r|r:ɛi::ɣ:ə:r	7
rein	r:ei:n|r:ɛi:n	2
reis	r:ei:s|r:ɛi:s	206
reist	r:ei:st|r:ɛi:st	8
reizen	r:ei::z:e:n|r:ɛi::z:ə:	16
rek	r:e:k|r:ɛ:k	63
rekenen	r:e::k:e::n:e:n|r:eː::k:ə::n:ə:	9
rekstok	r:e:k:st:o:k|r:ɛ:k:st:ɔ:k	12
rekt	r:e:kt|r:ɛ:kt	20
reling	r:e::l:i:ng|r:eː::l:ɪ:ŋ	3
rem	r:e:m|r:ɛ:m	61
remde	r:e:m:d:e:|r:ɛ:m:d:ə:	2
remmen	r:e:m:m:e:n|r:ɛ::m:ə:	2
remt	r:e:mt|r:ɛ:mt	8
ren	r:e:n|r:ɛ:n	182
rende	r:e:n:d:e:|r:ɛ:n:d:ə:	11
renden	r:e:n:d:e:n|r:ɛ:n:d:ə:	5
rennen	r:e:n:n:e:n|r:ɛ::n:ə:	113
rent	r:e:nt|r:ɛ:nt	363
rep	r:e:p|r:ɛ:p	4
repen	r:e::p:e:n|r:eː::p:ə:	3
rest	r:e:st|r:ɛ:st	41
restjes	r:e:st:j:e:s|r:ɛ:st:j:ə:s	4
reuk	r:eu:k|r:øː:k	10
reus	r:eu:s|r:øː:s	323
reuze	r:eu::z:e:|r:øː::z:ə:	7
reuzen	r:eu::z:e:n|r:øː::z:ə:	5
reuzenrad	r:eu::z:e:n:r:a:d|r:øː::z:ə::r:ɑ:t	3
rib	r:i:b|r:ɪ:p	4
richt	r:i:cht|r:ɪ:çt	8
richting	r:i:ch:t:i:ng|r:ɪ:ç:t:ɪ:ŋ	6
ridder	r:i:d:d:e:r|r:ɪ::d:ə:r	103
ridders	r:i:d:d:e:rs|r:ɪ::d:ə:rs	22
riek	r:ie:k|r:iː:k	5
riem	r:ie:m|r:iː:m	96
riemen	r:ie::m:e:n|r:iː::m:ə:	5
riempje	r:ie:m:pj:e:|r:iː:m:pj:ə:	4
riep	r:ie:p|r:iː:p	65
riepen	r:ie::p:e:n|r:iː::p:ə:	13
riet	r:ie:t|r:iː:t	251
rietje	r:ie:t:j:e:|r:iː:t:j:ə:	3
rietjes	r:ie:t:j:e:s|r:iː:t:j:ə:s	2
rij	r:ij:|r:ɛi:	95
rijbewijs	r:ij::b:e::w:ij:s|r:ɛi::b:ə::w:ɛi:s	2
rijd	r:ij:d|r:ɛi:t	8
rijden	r:ij::d:e:n|r:ɛi::d:ə:	54
rijdt	r:ij:dt|r:ɛi:t	56
rijen	r:ij:::e:n|r:ɛi::j:ə:	3
rijg	r:ij:g|r:ɛi:ç	2
rijk	r:ij:k|r:ɛi:k	58
rijke	r:ij::k:e:|r:ɛi::k:ə:	4
rijm	r:ij:m|r:ɛi:m	37
rijmen	r:ij::m:e:n|r:ɛi::m:ə:	10
rijmpje	r:ij:m:pj:e:|r:ɛi:m:pj:ə:	6
rijmt	r:ij:mt|r:ɛi:mt	59
rijmwoord	r:ij:m:w:oo:rd|r:ɛi:m:w:oː:rt	2
rijn	r:ij:n|r:ɛi:n	6
rijp	r:ij:p|r:ɛi:p	11
rijst	r:ij:st|r:ɛi:st	20
rijstebrij	r:ij:s:t:e::br:ij:|r:ɛi:s:t:ə::br:ɛi:	7
rijtje	r:ij::tj:e:|r:ɛi::tj:ə:	5
rijzen	r:ij::z:e:n|r:ɛi::z:ə:	3
rik	r:i:k|r:ɪ:k	131
ril	r:i:l|r:ɪ:l	21
rillen	r:i:l:l:e:n|r:ɪ::l:ə:	3
rilt	r:i:lt|r:ɪ:lt	40
rimpels	r:i:m:p:e:ls|r:ɪ:m:p:ə:ls	3
ring	r:i:ng|r:ɪ:ŋ	64
ringen	r:i:n:g:e:n|r:ɪ::ŋ:ə:	5
ringetje	r:i:n:g:e::tj:e:|r:ɪ::ŋ:ə::tj:ə:	2
rinkelt	r:i:n:k:e:lt|r:ɪ:ŋ:k:ə:lt	2
ris	r:i:s|r:ɪ:s	3
rit	r:i:t|r:ɪ:t	15
rits	r:i:ts|r:ɪ:ts	44
ritselen	r:i:t:s:e::l:e:n|r:ɪ:t:s:ə::l:ə:	5
ritselt	r:i:t:s:e:lt|r:ɪ:t:s:ə:lt	5
ritsen	r:i:t:s:e:n|r:ɪ:t:s:ə:	6
rivier	r:i::v:ie:r|r:iː::v:iː:r	25
rob	r:o:b|r:ɔ:p	81
rode	r:o::d:e:|r:oː::d:ə:	82
roder	r:o::d:e:r|r:oː::d:ə:r	3
roe	r:oe:|r:uː:	17
roei	r:oe:i|r:uː:j	12
roeiboot	r:oe:i:b:oo:t|r:uː:j:b:oː:t	14
roeien	r:oe:i::e:n|r:uː::j:ə:	13
roeit	r:oe:it|r:uː:jt	3
roep	r:oe:p|r:uː:p	74
roepen	r:oe::p:e:n|r:uː::p:ə:	97
roept	r:oe:pt|r:uː:pt	1478
roer	r:oe:r|r:uː:r	59
roeren	r:oe::r:e:n|r:uː::r:ə:	5
roert	r:oe:rt|r:uː:rt	28
roet	r:oe:t|r:uː:t	41
roetsj	r:oe:tsj|r:uː:tʃ	2
rok	r:o:k|r:ɔ:k	44
roken	r:o::k:e:n|r:oː::k:ə:	4
rokje	r:o:k:j:e:|r:ɔ:k:j:ə:	11
rol	r:o:l|r:ɔ:l	18
rolde	r:o:l:d:e:|r:ɔ:l:d:ə:	2
rollen	r:o:l:l:e:n|r:ɔ::l:ə:	22
roller	r:o:l:l:e:r|r:ɔ::l:ə:r	2
rolletje	r:o:l:l:e::tj:e:|r:ɔ::l:ə::tj:ə:	2
rolstoel	r:o:l:st:oe:l|r:ɔ:l:st:uː:l	18
rolt	r:o:lt|r:ɔ:lt	56
rommel	r:o:m:m:e:l|r:ɔ::m:ə:l	12
rommelen	r:o:m:m:e::l:e:n|r:ɔ::m:ə::l:ə:	2
rommelt	r:o:m:m:e:lt|r:ɔ::m:ə:lt	3
rond	r:o:nd|r:ɔ:nt	170
ronde	r:o:n:d:e:|r:ɔ:n:d:ə:	13
ronder	r:o:n:d:e:r|r:ɔ:n:d:ə:r	2
rondje	r:o:nd:j:e:|r:ɔ:nt:j:ə:	16
rondjes	r:o:nd:j:e:s|r:ɔ:nt:j:ə:s	13
rondom	r:o:nd::o:m|r:ɔ:nd::ɔ:m	5
rood	r:oo:d|r:oː:t	164
roof	r:oo:f|r:oː:f	3
rooft	r:oo:ft|r:oː:ft	2
roofvogel	r:oo:f:v:o::g:e:l|r:oː::f:oː::ɣ:ə:l	8
rooie	r:oo:i::e:|r:oː::j:ə:	2
rook	r:oo:k|r:oː:k	98
rookt	r:oo:kt|r:oː:kt	9
room	r:oo:m|r:oː:m	112
roomsoes	r:oo:m:s:oe:s|r:oː:m:s:uː:s	4
roos	r:oo:s|r:oː:s	601
roosje	r:oo:s:j:e:|r:oː:s:j:ə:	4
rooster	r:oo:s:t:e:r|r:oː:s:t:ə:r	2
ros	r:o:s|r:ɔ:s	3
rot	r:o:t|r:ɔ:t	48
rots	r:o:ts|r:ɔ:ts	31
rotsen	r:o:t:s:e:n|r:ɔ:t:s:ə:	3
rotzooi	r:o:t:z:oo:i|r:ɔ:t:s:oː:j	9
rouw	r:ou:w|r:ɑu:w	2
rover	r:o::v:e:r|r:oː::v:ə:r	38
rovers	r:o::v:e:rs|r:oː::v:ə:rs	56
roze	r:o::z:e:|r:oː::z:ə:	37
roze	r:o::z:e:|r:ɒː::z:ə:	37
rozen	r:o::z:e:n|r:oː::z:ə:	17
rozijnen	r:o::z:ij::n:e:n|r:oː::z:ɛi::n:ə:	3
rug	r:u:g|r:ʉ:ç	110
rugzak	r:u:g:z:a:k|r:ʉ:ç:s:ɑ:k	42
ruig	r:ui:g|r:œy:ç	2
ruige	r:ui::g:e:|r:œy::ɣ:ə:	2
ruik	r:ui:k|r:œy:k	46
ruiken	r:ui::k:e:n|r:œy::k:ə:	40
ruikt	r:ui:kt|r:œy:kt	146
ruil	r:ui:l|r:œy:l	7
ruilen	r:ui::l:e:n|r:œy::l:ə:	8
ruilt	r:ui:lt|r:œy:lt	2
ruim	r:ui:m|r:œy:m	33
ruimen	r:ui::m:e:n|r:œy::m:ə:	10
ruimt	r:ui:mt|r:œy:mt	8
ruimte	r:ui:m:t:e:|r:œy:m:t:ə:	19
ruisen	r:ui::s:e:n|r:œy::s:ə:	2
ruist	r:ui:st|r:œy:st	5
ruit	r:ui:t|r:œy:t	24
ruiter	r:ui::t:e:r|r:œy::t:ə:r	9
ruk	r:u:k|r:ʉ:k	11
rukt	r:u:kt|r:ʉ:kt	20
rum	r:u:m|r:ʉ:m	6
rups	r:u:ps|r:ʉ:ps	27
rupsen	r:u:p:s:e:n|r:ʉ:p:s:ə:	2
rust	r:u:st|r:ʉ:st	37
rusten	r:u:s:t:e:n|r:ʉ:s:t:ə:	8
rustig	r:u:s:t:i:g|r:ʉ:s:t:ə:ç	36
rustiger	r:u:s:t:i::g:e:r|r:ʉ:s:t:ə::ɣ:ə:r	2
ruw	r:u:w|r:yː:w	31
ruzie	r:u::z:ie:|r:yː::z:iː:	24
s	s::|:ɛ:s	444
sa	s:a:|s:aː:	4
saai	s:aa:i|s:aː:j	81
saaie	s:aa:i::e:|s:aː::j:ə:	6
saaiste	s:aa:i:st:e:|s:aː:j:st:ə:	2
samen	s:a::m:e:n|s:aː::m:ə:	188
sap	s:a:p|s:ɑ:p	71
sauna	s:au::n:a:|s:ɑu::n:aː:	2
saus	s:au:s|s:ɑu:s	57
schaaf	sch:aa:f|sç:aː:f	5
schaaft	sch:aa:ft|sç:aː:ft	2
schaak	sch:aa:k|sç:aː:k	3
schaal	sch:aa:l|sç:aː:l	34
schaaltje	sch:aa:l:tj:e:|sç:aː:l:tj:ə:	4
schaamt	sch:aa:mt|sç:aː:mt	4
schaap	sch:aa:p|sç:aː:p	42
schaar	sch:aa:r|sç:aː:r	45
schaartje	sch:aa:r:tj:e:|sç:aː:r:tj:ə:	3
schaats	sch:aa:ts|sç:aː:ts	8
schaatsen	sch:aa:t:s:e:n|sç:aː:t:s:ə:	8
schaduw	sch:a::d:u:w|sç:aː::d:yː:w	11
schakelaar	sch:a::k:e::l:aa:r|sç:aː::k:ə::l:aː:r	2
schamen	sch:a::m:e:n|sç:aː::m:ə:	2
schapen	sch:a::p:e:n|sç:aː::p:ə:	21
scharen	sch:a::r:e:n|sç:aː::r:ə:	5
schat	sch:a:t|sç:ɑ:t	344
schatert	sch:a::t:e:rt|sç:aː::t:ə:rt	4
schatje	sch:a:t:j:e:|sç:ɑ:t:j:ə:	3
schatkist	sch:a:t:k:i:st|sç:ɑ:t:k:ɪ:st	41
schatten	sch:a:t:t:e:n|sç:ɑ::t:ə:	19
schattig	sch:a:t:t:i:g|sç:ɑ::t:ə:ç	6
scheef	sch:ee:f|sç:eː:f	24
scheel	sch:ee:l|sç:eː:l	6
scheen	sch:ee:n|sç:eː:n	8
scheer	sch:ee:r|sç:eː:r	3
schel	sch:e:l|sç:ɛ:l	2
schelden	sch:e:l:d:e:n|sç:ɛ:l:d:ə:	2
schelen	sch:e::l:e:n|sç:eː::l:ə:	9
schelp	sch:e:lp|sç:ɛ:lp	46
schelpen	sch:e:l:p:e:n|sç:ɛ:l:p:ə:	20
schenk	sch:e:nk|sç:ɛ:ŋk	16
schenkt	sch:e:nkt|sç:ɛ:ŋkt	7
schep	sch:e:p|sç:ɛ:p	53
schepen	sch:e::p:e:n|sç:eː::p:ə:	10
schepjes	sch:e:p:j:e:s|sç:ɛ:p:j:ə:s	2
scheppen	sch:e:p:p:e:n|sç:ɛ::p:ə:	6
schept	sch:e:pt|sç:ɛ:pt	14
scherf	sch:e:rf|sç:ɛ:rf	6
scherm	sch:e:rm|sç:ɛ:rm	5
scherp	sch:e:rp|sç:ɛ:rp	19
scherpe	sch:e:r:p:e:|sç:ɛ:r:p:ə:	15
scherven	sch:e:r:v:e:n|sç:ɛ:r:v:ə:	2
scheur	sch:eu:r|sç:øː:r	11
scheurt	sch:eu:rt|sç:øː:rt	6
scheut	sch:eu:t|sç:øː:t	4
schiet	sch:ie:t|sç:iː:t	103
schieten	sch:ie::t:e:n|sç:iː::t:ə:	21
schijf	sch:ij:f|sç:ɛi:f	2
schijn	sch:ij:n|sç:ɛi:n	5
schijnen	sch:ij::n:e:n|sç:ɛi::n:ə:	4
schijnt	sch:ij:nt|sç:ɛi:nt	40
schil	sch:i:l|sç:ɪ:l	14
schild	sch:i:ld|sç:ɪ:lt	12
schilder	sch:i:l:d:e:r|sç:ɪ:l:d:ə:r	17
schilderij	sch:i:l:d:e::r:ij:|sç:ɪ:l:d:ə::r:ɛi:	6
schildert	sch:i:l:d:e:rt|sç:ɪ:l:d:ə:rt	7
schildpad	sch:i:ld:p:a:d|sç:ɪ:lt:p:ɑ:t	14
schilfers	sch:i:l:f:e:rs|sç:ɪ:l:f:ə:rs	2
schillen	sch:i:l:l:e:n|sç:ɪ::l:ə:	3
schilt	sch:i:lt|sç:ɪ:lt	3
schim	sch:i:m|sç:ɪ:m	6
schip	sch:i:p|sç:ɪ:p	136
schoen	sch:oe:n|sç:uː:n	59
schoenen	sch:oe::n:e:n|sç:uː::n:ə:	41
schoentje	sch:oe:n:tj:e:|sç:uː:n:tj:ə:	9
schoentjes	sch:oe:n:tj:e:s|sç:uː:n:tj:ə:s	7
schok	sch:o:k|sç:ɔ:k	3
schokt	sch:o:kt|sç:ɔ:kt	3
scholen	sch:o::l:e:n|sç:oː::l:ə:	7
schommel	sch:o:m:m:e:l|sç:ɔ::m:ə:l	10
schommelt	sch:o:m:m:e:lt|sç:ɔ::m:ə:lt	3
schone	sch:o::n:e:|sç:oː::n:ə:	6
schoof	sch:oo:f|sç:oː:f	3
school	sch:oo:l|sç:oː:l	264
schoolboeken	sch:oo:l:b:oe::k:e:n|sç:oː:l:b:uː::k:ə:	4
schoolbord	sch:oo:l:b:o:rd|sç:oː:l:b:ɔ:rt	5
schooldag	sch:oo:l:d:a:g|sç:oː:l:d:ɑ:ç	2
schooljaar	sch:oo:l:j:aa:r|sç:oː:l:j:aː:r	4
schooljuf	sch:oo:l:j:u:f|sç:oː:l:j:ʉ:f	2
schoolplein	sch:oo:l:pl:ei:n|sç:oː:l:pl:ɛi:n	9
schoolreis	sch:oo:l:r:ei:s|sç:oː:l:r:ɛi:s	5
schooltas	sch:oo:l:t:a:s|sç:oː:l:t:ɑ:s	4
schooltijd	sch:oo:l:t:ij:d|sç:oː:l:t:ɛi:t	2
schoon	sch:oo:n|sç:oː:n	57
schoongemaakt	sch:oo:n:g:e::m:aa:kt|sç:oː:ŋ:ɣ:ə::m:aː:kt	3
schoonmaak	sch:oo:n:m:aa:k|sç:oː:n:m:aː:k	3
schoonmaken	sch:oo:n:m:a::k:e:n|sç:oː:n:m:aː::k:ə:	2
schoorsteen	sch:oo:r:st:ee:n|sç:oː:r:st:eː:n	6
schoot	sch:oo:t|sç:oː:t	29
schop	sch:o:p|sç:ɔ:p	23
schoppen	sch:o:p:p:e:n|sç:ɔ::p:ə:	5
schopt	sch:o:pt|sç:ɔ:pt	22
schor	sch:o:r|sç:ɔ:r	10
schort	sch:o:rt|sç:ɔ:rt	15
schorten	sch:o:r:t:e:n|sç:ɔ:r:t:ə:	3
schot	sch:o:t|sç:ɔ:t	5
schouder	sch:ou::d:e:r|sç:ɑu::d:ə:r	13
schouders	sch:ou::d:e:rs|sç:ɑu::d:ə:rs	31
schraapt	schr:aa:pt|sçr:aː:pt	3
schram	schr:a:m|sçr:ɑ:m	2
schreef	schr:ee:f|sçr:eː:f	25
schreeuw	schr:ee:uw|sçr:eː:w	24
schreeuwen	schr:ee:uw::e:n|sçr:eː::w:ə:	16
schreeuwt	schr:ee:uwt|sçr:eː:wt	60
schrift	schr:i:ft|sçr:ɪ:ft	15
schriften	schr:i:f:t:e:n|sçr:ɪ:f:t:ə:	5
schrijf	schr:ij:f|sçr:ɛi:f	97
schrijfster	schr:ij:f:st:e:r|sçr:ɛi:f:st:ə:r	5
schrijft	schr:ij:ft|sçr:ɛi:ft	43
schrijven	schr:ij::v:e:n|sçr:ɛi::v:ə:	51
schrijver	schr:ij::v:e:r|sçr:ɛi::v:ə:r	6
schrik	schr:i:k|sçr:ɪ:k	39
schrikken	schr:i:k:k:e:n|sçr:ɪ::k:ə:	9
schrikt	schr:i:kt|sçr:ɪ:kt	77
schrobt	schr:o:bt|sçr:ɔ:pt	2
schroef	schr:oe:f|sçr:uː:f	30
schroeft	schr:oe:ft|sçr:uː:ft	3
schroeven	schr:oe::v:e:n|sçr:uː::v:ə:	23
schrok	schr:o:k|sçr:ɔ:k	13
schudde	sch:u:d:d:e:|sç:ʉ::d:ə:	6
schudden	sch:u:d:d:e:n|sç:ʉ::d:ə:	10
schudt	sch:u:dt|sç:ʉ:t	114
schuif	sch:ui:f|sç:œy:f	11
schuifelen	sch:ui::f:e::l:e:n|sç:œy::f:ə::l:ə:	2
schuifelt	sch:ui::f:e:lt|sç:œy::f:ə:lt	5
schuifje	sch:ui:f:j:e:|sç:œy:f:j:ə:	6
schuift	sch:ui:ft|sç:œy:ft	48
schuil	sch:ui:l|sç:œy:l	6
schuilen	sch:ui::l:e:n|sç:œy::l:ə:	2
schuilplaats	sch:ui:l:pl:aa:ts|sç:œy:l:pl:aː:ts	2
schuilt	sch:ui:lt|sç:œy:lt	2
schuim	sch:ui:m|sç:œy:m	28
schuin	sch:ui:n|sç:œy:n	32
schuine	sch:ui::n:e:|sç:œy::n:ə:	2
schuit	sch:ui:t|sç:œy:t	7
schuiven	sch:ui::v:e:n|sç:œy::v:ə:	5
schuld	sch:u:ld|sç:ʉ:lt	26
schuren	sch:u::r:e:n|sç:yː::r:ə:	7
schurk	sch:u:rk|sç:ʉ:rk	3
schuur	sch:uu:r|sç:yː:r	94
schuurt	sch:uu:rt|sç:yː:rt	2
schuurtje	sch:uu:r:tj:e:|sç:yː:r:tj:ə:	6
schuw	sch:u:w|sç:yː:w	4
sein	s:ei:n|s:ɛi:n	3
seizoen	s:ei::z:oe:n|s:ɛi::z:uː:n	4
sen	s:e:n|s:ɛ:n	5
september	s:e:p:t:e:m:b:e:r|s:ɛ:p:t:ɛ:m:b:ə:r	4
serie	s:e::r:ie:|s:eː::r:iː:	6
seringen	s:e::r:i:n:g:e:n|s:ə::r:ɪ::ŋ:ə:	2
servet	s:e:r:v:e:t|s:ɛ:r:v:ɛ:t	10
serviesje	s:e:r:v:ie:s:j:e:|s:ɛ:r:v:iː:s:j:ə:	2
shirt	sh:i:rt|ʃ:ʉ:rt	5
si	s:i:|s:iː:	7
sieraden	s:ie::r:a::d:e:n|s:iː::r:aː::d:ə:	3
sierlijk	s:ie:r:l:ij:k|s:iː:r:l:ə:k	5
sigaar	s:i::g:aa:r|s:iː::ɣ:aː:r	6
sijs	s:ij:s|s:ɛi:s	2
sik	s:i:k|s:ɪ:k	69
sim	s:i:m|s:ɪ:m	26
simpel	s:i:m:p:e:l|s:ɪ:m:p:ə:l	13
sinds	s:i:nds|s:ɪ:nts	13
sinterklaas	s:i:n:t:e:r:kl:aa:s|s:ɪ:n:t:ə:r:kl:aː:s	10
sip	s:i:p|s:ɪ:p	103
sis	s:i:s|s:ɪ:s	46
sist	s:i:st|s:ɪ:st	32
sjaal	sj:aa:l|ʃ:aː:l	19
sjokt	sj:o:kt|ʃ:ɔ:kt	7
sjouw	sj:ou:w|ʃ:ɑu:w	2
sjouwen	sj:ou::w:e:n|ʃ:ɑu::w:ə:	5
sjouwt	sj:ou:wt|ʃ:ɑu:wt	2
skelet	sk:e::l:e:t|sk:ə::l:ɛ:t	4
sla	sl:a:|sl:aː:	52
slaakt	sl:aa:kt|sl:aː:kt	2
slaan	sl:aa:n|sl:aː:n	26
slaap	sl:aa:p|sl:aː:p	85
slaapkamer	sl:aa:p:k:a::m:e:r|sl:aː:p:k:aː::m:ə:r	11
slaapt	sl:aa:pt|sl:aː:pt	73
slaapzak	sl:aa:p:z:a:k|sl:aː:p:s:ɑ:k	11
slaat	sl:aa:t|sl:aː:t	98
slacht	sl:a:cht|sl:ɑ:çt	3
slag	sl:a:g|sl:ɑ:ç	28
slagen	sl:a::g:e:n|sl:aː::ɣ:ə:	3
slager	sl:a::g:e:r|sl:aː::ɣ:ə:r	11
slagroom	sl:a:g:r:oo:m|sl:ɑ:ɣ:r:oː:m	17
slak	sl:a:k|sl:ɑ:k	90
slakken	sl:a:k:k:e:n|sl:ɑ::k:ə:	3
slang	sl:a:ng|sl:ɑ:ŋ	87
slang	sl:a:ng|sl:ɛ:ŋ	87
slangen	sl:a:n:g:e:n|sl:ɑ::ŋ:ə:	12
slangetje	sl:a:n:g:e::tj:e:|sl:ɑ::ŋ:ə::tj:ə:	3
slank	sl:a:nk|sl:ɑ:ŋk	9
slap	sl:a:p|sl:ɑ:p	9
slapen	sl:a::p:e:n|sl:aː::p:ə:	114
slapend	sl:a::p:e:nd|sl:aː::p:ə:nt	3
slappe	sl:a:p:p:e:|sl:ɑ::p:ə:	6
slecht	sl:e:cht|sl:ɛ:çt	14
slechte	sl:e:ch:t:e:|sl:ɛ:ç:t:ə:	3
slee	sl:ee:|sl:eː:	13
sleept	sl:ee:pt|sl:eː:pt	7
slepen	sl:e::p:e:n|sl:eː::p:ə:	4
sleurt	sl:eu:rt|sl:øː:rt	6
sleutel	sl:eu::t:e:l|sl:øː::t:ə:l	10
sleutelbos	sl:eu::t:e:l:b:o:s|sl:øː::t:ə:l:b:ɔ:s	3
sliep	sl:ie:p|sl:iː:p	15
slierten	sl:ie:r:t:e:n|sl:iː:r:t:ə:	4
sliertjes	sl:ie:r:tj:e:s|sl:iː:r:tj:ə:s	3
slijm	sl:ij:m|sl:ɛi:m	3
slijpt	sl:ij:pt|sl:ɛi:pt	2
slik	sl:i:k|sl:ɪ:k	3
slikken	sl:i:k:k:e:n|sl:ɪ::k:ə:	6
slikt	sl:i:kt|sl:ɪ:kt	27
slim	sl:i:m|sl:ɪ:m	41
slimme	sl:i:m:m:e:|sl:ɪ::m:ə:	5
slimmer	sl:i:m:m:e:r|sl:ɪ::m:ə:r	5
slinger	sl:i:n:g:e:r|sl:ɪ::ŋ:ə:r	8
slingeren	sl:i:n:g:e::r:e:n|sl:ɪ::ŋ:ə::r:ə:	5
slingers	sl:i:n:g:e:rs|sl:ɪ::ŋ:ə:rs	14
slingert	sl:i:n:g:e:rt|sl:ɪ::ŋ:ə:rt	6
slippers	sl:i:p:p:e:rs|sl:ɪ::p:ə:rs	3
sloeg	sl:oe:g|sl:uː:ç	8
sloep	sl:oe:p|sl:uː:p	3
slok	sl:o:k|sl:ɔ:k	17
slokje	sl:o:k:j:e:|sl:ɔ:k:j:ə:	3
slomer	sl:o::m:e:r|sl:oː::m:ə:r	2
sloom	sl:oo:m|sl:oː:m	6
sloot	sl:oo:t|sl:oː:t	44
slot	sl:o:t|sl:ɔ:t	49
slotje	sl:o:t:j:e:|sl:ɔ:t:j:ə:	5
sluip	sl:ui:p|sl:œy:p	2
sluipen	sl:ui::p:e:n|sl:œy::p:ə:	10
sluipt	sl:ui:pt|sl:œy:pt	36
sluit	sl:ui:t|sl:œy:t	23
sluiten	sl:ui::t:e:n|sl:œy::t:ə:	3
slurf	sl:u:rf|sl:ʉ:rf	9
sluw	sl:u:w|sl:yː:w	6
smaak	sm:aa:k|sm:aː:k	4
smaakt	sm:aa:kt|sm:aː:kt	41
smak	sm:a:k|sm:ɑ:k	7
smakelijk	sm:a::k:e::l:ij:k|sm:aː::k:ə::l:ə:k	2
smaken	sm:a::k:e:n|sm:aː::k:ə:	6
smakken	sm:a:k:k:e:n|sm:ɑ::k:ə:	2
smakt	sm:a:kt|sm:ɑ:kt	8
smal	sm:a:l|sm:ɑ:l	9
smalle	sm:a:l:l:e:|sm:ɑ::l:ə:	6
smeekt	sm:ee:kt|sm:eː:kt	3
smeer	sm:ee:r|sm:eː:r	13
smeerkaas	sm:ee:r:k:aa:s|sm:eː:r:k:aː:s	2
smeert	sm:ee:rt|sm:eː:rt	8
smekend	sm:e::k:e:nd|sm:eː::k:ə:nt	2
smelt	sm:e:lt|sm:ɛ:lt	4
smeren	sm:e::r:e:n|sm:eː::r:ə:	4
smerig	sm:e::r:i:g|sm:eː::r:ə:ç	10
smid	sm:i:d|sm:ɪ:t	6
smijt	sm:ij:t|sm:ɛi:t	6
smoes	sm:oe:s|sm:uː:s	2
smoesjes	sm:oe:s:j:e:s|sm:uː:s:j:ə:s	3
smullen	sm:u:l:l:e:n|sm:ʉ::l:ə:	17
smult	sm:u:lt|sm:ʉ:lt	3
snaar	sn:aa:r|sn:aː:r	11
snap	sn:a:p|sn:ɑ:p	78
snappen	sn:a:p:p:e:n|sn:ɑ::p:ə:	9
snapt	sn:a:pt|sn:ɑ:pt	76
snapte	sn:a:p:t:e:|sn:ɑ:p:t:ə:	3
snaren	sn:a::r:e:n|sn:aː::r:ə:	11
snauwt	sn:au:wt|sn:ɑu:wt	6
snavel	sn:a::v:e:l|sn:aː::v:ə:l	6
snee	sn:ee:|sn:eː:	18
sneed	sn:ee:d|sn:eː:t	2
sneetje	sn:ee::tj:e:|sn:eː::tj:ə:	2
sneeuw	sn:ee:uw|sn:eː:w	74
sneeuwbal	sn:ee:uw:b:a:l|sn:eː:w:b:ɑ:l	4
sneeuwballen	sn:ee:uw:b:a:l:l:e:n|sn:eː:w:b:ɑ::l:ə:	4
sneeuwen	sn:ee:uw::e:n|sn:eː::w:ə:	2
sneeuwpop	sn:ee:uw:p:o:p|sn:eː:w:p:ɔ:p	2
sneeuwt	sn:ee:uwt|sn:eː:wt	4
snel	sn:e:l|sn:ɛ:l	374
snelle	sn:e:l:l:e:|sn:ɛ::l:ə:	2
sneller	sn:e:l:l:e:r|sn:ɛ::l:ə:r	35
snelst	sn:e:lst|sn:ɛ:lst	9
snelt	sn:e:lt|sn:ɛ:lt	2
sneu	sn:eu:|sn:øː:	3
snijd	sn:ij:d|sn:ɛi:t	10
snijden	sn:ij::d:e:n|sn:ɛi::d:ə:	4
snijdt	sn:ij:dt|sn:ɛi:t	18
snik	sn:i:k|sn:ɪ:k	6
snikken	sn:i:k:k:e:n|sn:ɪ::k:ə:	3
snikt	sn:i:kt|sn:ɪ:kt	24
snikte	sn:i:k:t:e:|sn:ɪ:k:t:ə:	2
snoei	sn:oe:i|sn:uː:j	5
snoep	sn:oe:p|sn:uː:p	69
snoepen	sn:oe::p:e:n|sn:uː::p:ə:	5
snoepje	sn:oe:p:j:e:|sn:uː:p:j:ə:	11
snoepjes	sn:oe:p:j:e:s|sn:uː:p:j:ə:s	11
snoept	sn:oe:pt|sn:uː:pt	2
snoes	sn:oe:s|sn:uː:s	4
snoet	sn:oe:t|sn:uː:t	7
snor	sn:o:r|sn:ɔ:r	21
snorren	sn:o:r:r:e:n|sn:ɔ::r:ə:	3
snot	sn:o:t|sn:ɔ:t	9
snottert	sn:o:t:t:e:rt|sn:ɔ::t:ə:rt	3
snuffelen	sn:u:f:f:e::l:e:n|sn:ʉ::f:ə::l:ə:	5
snuffelt	sn:u:f:f:e:lt|sn:ʉ::f:ə:lt	15
snufje	sn:u:f:j:e:|sn:ʉ:f:j:ə:	2
snuft	sn:u:ft|sn:ʉ:ft	6
snuift	sn:ui:ft|sn:œy:ft	16
snuit	sn:ui:t|sn:œy:t	29
snuiven	sn:ui::v:e:n|sn:œy::v:ə:	2
snurk	sn:u:rk|sn:ʉ:rk	5
snurken	sn:u:r:k:e:n|sn:ʉ:r:k:ə:	5
snurkt	sn:u:rkt|sn:ʉ:rkt	3
soep	s:oe:p|s:uː:p	266
soepel	s:oe::p:e:l|s:uː::p:ə:l	4
soepje	s:oe:p:j:e:|s:uː:p:j:ə:	2
soes	s:oe:s|s:uː:s	14
sof	s:o:f|s:ɔ:f	4
sok	s:o:k|s:ɔ:k	204
sokken	s:o:k:k:e:n|s:ɔ::k:ə:	14
som	s:o:m|s:ɔ:m	43
somber	s:o:m:b:e:r|s:ɔ:m:b:ə:r	16
sommen	s:o:m:m:e:n|s:ɔ::m:ə:	3
sommetje	s:o:m:m:e::tj:e:|s:ɔ::m:ə::tj:ə:	5
sommige	s:o:m:m:i::g:e:|s:ɔ::m:ə::ɣ:ə:	13
soms	s:o:ms|s:ɔ:ms	257
soort	s:oo:rt|s:oː:rt	74
soorten	s:oo:r:t:e:n|s:oː:r:t:ə:	17
sop	s:o:p|s:ɔ:p	28
sopje	s:o:p:j:e:|s:ɔ:p:j:ə:	2
sopt	s:o:pt|s:ɔ:pt	3
sorry	s:o:r:r:y:|s:ɔ::r:iː:	9
spaans	sp:aa:ns|sp:aː:ns	2
spaanse	sp:aa:n:s:e:|sp:aː:n:s:ə:	2
spaar	sp:aa:r|sp:aː:r	68
spaarpot	sp:aa:r:p:o:t|sp:aː:r:p:ɔ:t	2
spaart	sp:aa:rt|sp:aː:rt	40
spannend	sp:a:n:n:e:nd|sp:ɑ::n:ə:nt	59
spannende	sp:a:n:n:e:n:d:e:|sp:ɑ::n:ə:n:d:ə:	7
spanning	sp:a:n:n:i:ng|sp:ɑ::n:ɪ:ŋ	3
spant	sp:a:nt|sp:ɑ:nt	4
sparen	sp:a::r:e:n|sp:aː::r:ə:	24
spat	sp:a:t|sp:ɑ:t	11
spatten	sp:a:t:t:e:n|sp:ɑ::t:ə:	3
speel	sp:ee:l|sp:eː:l	44
speelde	sp:ee:l:d:e:|sp:eː:l:d:ə:	5
speelden	sp:ee:l:d:e:n|sp:eː:l:d:ə:	4
speelgoed	sp:ee:l:g:oe:d|sp:eː:l:ɣ:uː:t	20
speelplaats	sp:ee:l:pl:aa:ts|sp:eː:l:pl:aː:ts	3
speelt	sp:ee:lt|sp:eː:lt	115
speeltuin	sp:ee:l:t:ui:n|sp:eː:l:t:œy:n	29
speen	sp:ee:n|sp:eː:n	15
speer	sp:ee:r|sp:eː:r	21
spek	sp:e:k|sp:ɛ:k	14
spel	sp:e:l|sp:ɛ:l	141
spelen	sp:e::l:e:n|sp:eː::l:ə:	195
speler	sp:e::l:e:r|sp:eː::l:ə:r	6
spelers	sp:e::l:e:rs|sp:eː::l:ə:rs	11
spelletje	sp:e:l:l:e::tj:e:|sp:ɛ::l:ə::tj:ə:	24
spelletjes	sp:e:l:l:e::tj:e:s|sp:ɛ::l:ə::tj:ə:s	6
speren	sp:e::r:e:n|sp:eː::r:ə:	3
spert	sp:e:rt|sp:ɛ:rt	2
spetters	sp:e:t:t:e:rs|sp:ɛ::t:ə:rs	8
speur	sp:eu:r|sp:øː:r	5
speuren	sp:eu::r:e:n|sp:øː::r:ə:	6
speurt	sp:eu:rt|sp:øː:rt	12
speurtocht	sp:eu:r:t:o:cht|sp:øː:r:t:ɔ:çt	6
spiegel	sp:ie::g:e:l|sp:iː::ɣ:ə:l	40
spiegelei	sp:ie::g:e:l::ei:|sp:iː::ɣ:ə:l::ɛi:	4
spiegels	sp:ie::g:e:ls|sp:iː::ɣ:ə:ls	38
spiegeltje	sp:ie::g:e:l:tj:e:|sp:iː::ɣ:ə:l:tj:ə:	9
spier	sp:ie:r|sp:iː:r	3
spieren	sp:ie::r:e:n|sp:iː::r:ə:	3
spierwit	sp:ie:r:w:i:t|sp:iː:r:w:ɪ:t	2
spijker	sp:ij::k:e:r|sp:ɛi::k:ə:r	11
spijkerbroek	sp:ij::k:e:r:br:oe:k|sp:ɛi::k:ə:r:br:uː:k	2
spijkers	sp:ij::k:e:rs|sp:ɛi::k:ə:rs	6
spijt	sp:ij:t|sp:ɛi:t	29
spil	sp:i:l|sp:ɪ:l	3
spin	sp:i:n|sp:ɪ:n	82
spinazie	sp:i::n:a::z:ie:|sp:iː::n:aː::z:iː:	3
spinnen	sp:i:n:n:e:n|sp:ɪ::n:ə:	36
spinnetje	sp:i:n:n:e::tj:e:|sp:ɪ::n:ə::tj:ə:	3
spint	sp:i:nt|sp:ɪ:nt	5
spit	sp:i:t|sp:ɪ:t	3
spitse	sp:i:t:s:e:|sp:ɪ:t:s:ə:	3
spitst	sp:i:tst|sp:ɪ:tst	3
spleetjes	spl:ee:t:j:e:s|spl:eː:t:j:ə:s	3
spoelt	sp:oe:lt|sp:uː:lt	5
spoken	sp:o::k:e:n|sp:oː::k:ə:	6
spons	sp:o:ns|sp:ɔ:ns	9
spook	sp:oo:k|sp:oː:k	36
spookhuis	sp:oo:k:h:ui:s|sp:oː:k:h:œy:s	4
spoor	sp:oo:r|sp:oː:r	45
spoorloos	sp:oo:r:l:oo:s|sp:oː:r:l:oː:s	2
sporen	sp:o::r:e:n|sp:oː::r:ə:	11
sport	sp:o:rt|sp:ɔ:rt	11
sporten	sp:o:r:t:e:n|sp:ɔ:r:t:ə:	5
sprak	spr:a:k|spr:ɑ:k	6
sprake	spr:a::k:e:|spr:aː::k:ə:	5
spraken	spr:a::k:e:n|spr:aː::k:ə:	3
spreek	spr:ee:k|spr:eː:k	8
spreekbeurt	spr:ee:k:b:eu:rt|spr:eː:ɡ:b:øː:rt	10
spreekt	spr:ee:kt|spr:eː:kt	4
spreeuw	spr:ee:uw|spr:eː:w	3
sprei	spr:ei:|spr:ɛi:	5
spreken	spr:e::k:e:n|spr:eː::k:ə:	7
spreuk	spr:eu:k|spr:øː:k	10
spreuken	spr:eu::k:e:n|spr:øː::k:ə:	3
spriet	spr:ie:t|spr:iː:t	67
sprietjes	spr:ie:t:j:e:s|spr:iː:t:j:ə:s	3
spring	spr:i:ng|spr:ɪ:ŋ	19
springen	spr:i:n:g:e:n|spr:ɪ::ŋ:ə:	41
springt	spr:i:ngt|spr:ɪ:ŋt	137
sproei	spr:oe:i|spr:uː:j	9
sproeien	spr:oe:i::e:n|spr:uː::j:ə:	3
sproeit	spr:oe:it|spr:uː:jt	2
sproet	spr:oe:t|spr:uː:t	12
sproeten	spr:oe::t:e:n|spr:uː::t:ə:	2
sprong	spr:o:ng|spr:ɔ:ŋ	28
sprongen	spr:o:n:g:e:n|spr:ɔ::ŋ:ə:	9
sprongetje	spr:o:n:g:e::tj:e:|spr:ɔ::ŋ:ə::tj:ə:	3
sprookje	spr:oo:k:j:e:|spr:oː:k:j:ə:	6
sprookjes	spr:oo:k:j:e:s|spr:oː:k:j:ə:s	2
sprookjesland	spr:oo:k:j:e:s:l:a:nd|spr:oː:k:j:ə:s:l:ɑ:nt	2
spruit	spr:ui:t|spr:œy:t	7
spugen	sp:u::g:e:n|sp:yː::ɣ:ə:	3
spuit	sp:ui:t|sp:œy:t	33
spuitbus	sp:ui:t:b:u:s|sp:œy:d:b:ʉ:s	3
spuiten	sp:ui::t:e:n|sp:œy::t:ə:	2
spuitje	sp:ui:t:j:e:|sp:œy:t:j:ə:	4
spul	sp:u:l|sp:ʉ:l	6
spullen	sp:u:l:l:e:n|sp:ʉ::l:ə:	54
spulletjes	sp:u:l:l:e::tj:e:s|sp:ʉ::l:ə::tj:ə:s	2
spuug	sp:uu:g|sp:yː:ç	6
spuugt	sp:uu:gt|sp:yː:çt	16
sst	sst::|:s:t	14
st	st::|:s:t	5
sta	st:a:|st:aː:	28
staal	st:aa:l|st:aː:l	3
staan	st:aa:n|st:aː:n	429
staar	st:aa:r|st:aː:r	4
staart	st:aa:rt|st:aː:rt	150
staat	st:aa:t|st:aː:t	941
stad	st:a:d|st:ɑ:t	70
staf	st:a:f|st:ɑ:f	49
stafje	st:a:f:j:e:|st:ɑ:f:j:ə:	2
stak	st:a:k|st:ɑ:k	6
staken	st:a::k:e:n|st:aː::k:ə:	2
stakker	st:a:k:k:e:r|st:ɑ::k:ə:r	2
stal	st:a:l|st:ɑ:l	37
stallen	st:a:l:l:e:n|st:ɑ::l:ə:	3
stam	st:a:m|st:ɑ:m	11
stamelt	st:a::m:e:lt|st:aː::m:ə:lt	9
stamp	st:a:mp|st:ɑ:mp	5
stampen	st:a:m:p:e:n|st:ɑ:m:p:ə:	2
stampt	st:a:mpt|st:ɑ:mpt	9
standbeeld	st:a:nd:b:ee:ld|st:ɑ:nd:b:eː:lt	4
stang	st:a:ng|st:ɑ:ŋ	8
stank	st:a:nk|st:ɑ:ŋk	8
stap	st:a:p|st:ɑ:p	90
stapel	st:a::p:e:l|st:aː::p:ə:l	14
stappen	st:a:p:p:e:n|st:ɑ::p:ə:	53
stapt	st:a:pt|st:ɑ:pt	115
stapte	st:a:p:t:e:|st:ɑ:p:t:ə:	9
stapten	st:a:p:t:e:n|st:ɑ:p:t:ə:	4
staren	st:a::r:e:n|st:aː::r:ə:	6
start	st:a:rt|st:ɑ:rt	21
startbaan	st:a:rt:b:aa:n|st:ɑ:rd:b:aː:n	2
starten	st:a:r:t:e:n|st:ɑ:r:t:ə:	4
steden	st:e::d:e:n|st:eː::d:ə:	5
steeds	st:ee:ds|st:eː:ts	217
steeg	st:ee:g|st:eː:ç	6
steek	st:ee:k|st:eː:k	22
steekt	st:ee:kt|st:eː:kt	133
steel	st:ee:l|st:eː:l	10
steelt	st:ee:lt|st:eː:lt	8
steen	st:ee:n|st:eː:n	155
steentje	st:ee:n:tj:e:|st:eː:n:tj:ə:	6
steentjes	st:ee:n:tj:e:s|st:eː:n:tj:ə:s	3
stekel	st:e::k:e:l|st:eː::k:ə:l	5
stekels	st:e::k:e:ls|st:eː::k:ə:ls	15
steken	st:e::k:e:n|st:eː::k:ə:	14
stekker	st:e:k:k:e:r|st:ɛ::k:ə:r	7
stel	st:e:l|st:ɛ:l	58
stelen	st:e::l:e:n|st:eː::l:ə:	9
stellen	st:e:l:l:e:n|st:ɛ::l:ə:	2
stelt	st:e:lt|st:ɛ:lt	13
stelten	st:e:l:t:e:n|st:ɛ:l:t:ə:	5
stem	st:e:m|st:ɛ:m	147
stemmen	st:e:m:m:e:n|st:ɛ::m:ə:	7
stemmetje	st:e:m:m:e::tj:e:|st:ɛ::m:ə::tj:ə:	2
stempel	st:e:m:p:e:l|st:ɛ:m:p:ə:l	7
stempels	st:e:m:p:e:ls|st:ɛ:m:p:ə:ls	2
stenen	st:e::n:e:n|st:eː::n:ə:	34
stengel	st:e:n:g:e:l|st:ɛ::ŋ:ə:l	5
step	st:e:p|st:ɛ:p	38
ster	st:e:r|st:ɛ:r	41
sterf	st:e:rf|st:ɛ:rf	2
sterk	st:e:rk|st:ɛ:rk	43
sterke	st:e:r:k:e:|st:ɛ:r:k:ə:	7
sterker	st:e:r:k:e:r|st:ɛ:r:k:ə:r	6
sterren	st:e:r:r:e:n|st:ɛ::r:ə:	37
sterretje	st:e:r:r:e::tj:e:|st:ɛ::r:ə::tj:ə:	2
steunt	st:eu:nt|st:øː:nt	2
stevig	st:e::v:i:g|st:eː::v:ə:ç	24
stiekem	st:ie::k:e:m|st:iː::k:ə:m	10
stier	st:ie:r|st:iː:r	2
stift	st:i:ft|st:ɪ:ft	10
stiften	st:i:f:t:e:n|st:ɪ:f:t:ə:	12
stijf	st:ij:f|st:ɛi:f	7
stijgt	st:ij:gt|st:ɛi:çt	9
stikt	st:i:kt|st:ɪ:kt	4
stil	st:i:l|st:ɪ:l	284
stilletjes	st:i:l:l:e::tj:e:s|st:ɪ::l:ə::tj:ə:s	3
stilte	st:i:l:t:e:|st:ɪ:l:t:ə:	5
stilzitten	st:i:l:z:i:t:t:e:n|st:ɪ:l:z:ɪ::t:ə:	3
stink	st:i:nk|st:ɪ:ŋk	10
stinken	st:i:n:k:e:n|st:ɪ:ŋ:k:ə:	5
stinkt	st:i:nkt|st:ɪ:ŋkt	18
stip	st:i:p|st:ɪ:p	22
stippellijn	st:i:p:p:e:l:l:ij:n|st:ɪ::p:ə::l:ɛi:n	3
stippen	st:i:p:p:e:n|st:ɪ::p:ə:	13
stoei	st:oe:i|st:uː:j	10
stoeien	st:oe:i::e:n|st:uː::j:ə:	3
stoeit	st:oe:it|st:uː:jt	2
stoel	st:oe:l|st:uː:l	154
stoelen	st:oe::l:e:n|st:uː::l:ə:	22
stoeltje	st:oe:l:tj:e:|st:uː:l:tj:ə:	6
stoep	st:oe:p|st:uː:p	50
stoeprand	st:oe:p:r:a:nd|st:uː:p:r:ɑ:nt	2
stoer	st:oe:r|st:uː:r	58
stoere	st:oe::r:e:|st:uː::r:ə:	7
stof	st:o:f|st:ɔ:f	55
stofzuigen	st:o:f:z:ui::g:e:n|st:ɔ:f:s:œy::ɣ:ə:	3
stofzuiger	st:o:f:z:ui::g:e:r|st:ɔ:f:s:œy::ɣ:ə:r	2
stok	st:o:k|st:ɔ:k	64
stokje	st:o:k:j:e:|st:ɔ:k:j:ə:	16
stokjes	st:o:k:j:e:s|st:ɔ:k:j:ə:s	7
stokken	st:o:k:k:e:n|st:ɔ::k:ə:	3
stokstijf	st:o:k:st:ij:f|st:ɔ:k:st:ɛi:f	2
stom	st:o:m|st:ɔ:m	67
stomme	st:o:m:m:e:|st:ɔ::m:ə:	18
stomp	st:o:mp|st:ɔ:mp	8
stomverbaasd	st:o:m:v:e:r:b:aa:sd|st:ɔ:m:v:ə:r:b:aː:st	3
stond	st:o:nd|st:ɔ:nt	61
stonden	st:o:n:d:e:n|st:ɔ:n:d:ə:	9
stookt	st:oo:kt|st:oː:kt	4
stoom	st:oo:m|st:oː:m	2
stoomboot	st:oo:m:b:oo:t|st:oː:m:b:oː:t	4
stoop	st:oo:p|st:oː:p	2
stoor	st:oo:r|st:oː:r	5
stoort	st:oo:rt|st:oː:rt	2
stoot	st:oo:t|st:oː:t	26
stop	st:o:p|st:ɔ:p	68
stoplicht	st:o:p:l:i:cht|st:ɔ:p:l:ɪ:çt	3
stoppen	st:o:p:p:e:n|st:ɔ::p:ə:	19
stopt	st:o:pt|st:ɔ:pt	108
stopte	st:o:p:t:e:|st:ɔ:p:t:ə:	9
stopten	st:o:p:t:e:n|st:ɔ:p:t:ə:	2
storen	st:o::r:e:n|st:oː::r:ə:	2
storm	st:o:rm|st:ɔ:rm	34
stormen	st:o:r:m:e:n|st:ɔ:r:m:ə:	2
stormt	st:o:rmt|st:ɔ:rmt	7
stort	st:o:rt|st:ɔ:rt	7
storten	st:o:r:t:e:n|st:ɔ:r:t:ə:	4
stortte	st:o:rt:t:e:|st:ɔ:r:t:ə:	3
stottert	st:o:t:t:e:rt|st:ɔ::t:ə:rt	6
stout	st:ou:t|st:ɑu:t	4
straal	str:aa:l|str:aː:l	5
straalt	str:aa:lt|str:aː:lt	6
straaltje	str:aa:l:tj:e:|str:aː:l:tj:ə:	2
straat	str:aa:t|str:aː:t	123
straatje	str:aa:t:j:e:|str:aː:t:j:ə:	3
straf	str:a:f|str:ɑ:f	10
straffen	str:a:f:f:e:n|str:ɑ::f:ə:	2
strak	str:a:k|str:ɑ:k	13
strakke	str:a:k:k:e:|str:ɑ::k:ə:	2
straks	str:a:ks|str:ɑ:ks	148
stralen	str:a::l:e:n|str:aː::l:ə:	8
stralend	str:a::l:e:nd|str:aː::l:ə:nt	5
strand	str:a:nd|str:ɑ:nt	129
straten	str:a::t:e:n|str:aː::t:ə:	9
streek	str:ee:k|str:eː:k	4
streelt	str:ee:lt|str:eː:lt	3
streep	str:ee:p|str:eː:p	15
streepjes	str:ee:p:j:e:s|str:eː:p:j:ə:s	11
streken	str:e::k:e:n|str:eː::k:ə:	4
strekt	str:e:kt|str:ɛ:kt	5
strelen	str:e::l:e:n|str:eː::l:ə:	2
streng	str:e:ng|str:ɛ:ŋ	24
strepen	str:e::p:e:n|str:eː::p:ə:	15
strijk	str:ij:k|str:ɛi:k	6
strijken	str:ij::k:e:n|str:ɛi::k:ə:	2
strijkplank	str:ij:k:pl:a:nk|str:ɛi:k:pl:ɑ:ŋk	2
strijkt	str:ij:kt|str:ɛi:kt	12
strik	str:i:k|str:ɪ:k	20
strikken	str:i:k:k:e:n|str:ɪ::k:ə:	4
strip	str:i:p|str:ɪ:p	7
stripboeken	str:i:p:b:oe::k:e:n|str:ɪ::b:uː::k:ə:	3
strippenkaart	str:i:p:p:e:n:k:aa:rt|str:ɪ::p:ə::k:aː:rt	3
strips	str:i:ps|str:ɪ:ps	3
stro	str:o:|str:oː:	20
stroken	str:o::k:e:n|str:oː::k:ə:	3
stromen	str:o::m:e:n|str:oː::m:ə:	2
stronk	str:o:nk|str:ɔ:ŋk	4
strooi	str:oo:i|str:oː:j	17
strooit	str:oo:it|str:oː:jt	12
strook	str:oo:k|str:oː:k	9
stroom	str:oo:m|str:oː:m	8
stroomde	str:oo:m:d:e:|str:oː:m:d:ə:	3
stroomt	str:oo:mt|str:oː:mt	11
stroop	str:oo:p|str:oː:p	27
struik	str:ui:k|str:œy:k	53
struikelt	str:ui::k:e:lt|str:œy::k:ə:lt	6
struiken	str:ui::k:e:n|str:œy::k:ə:	19
stug	st:u:g|st:ʉ:ç	2
stuifmeel	st:ui:f:m:ee:l|st:œy:f:m:eː:l	3
stuift	st:ui:ft|st:œy:ft	8
stuiven	st:ui::v:e:n|st:œy::v:ə:	2
stuk	st:u:k|st:ʉ:k	176
stukje	st:u:k:j:e:|st:ʉ:k:j:ə:	47
stukjes	st:u:k:j:e:s|st:ʉ:k:j:ə:s	17
stukken	st:u:k:k:e:n|st:ʉ::k:ə:	24
stunt	st:u:nt|st:ʉ:nt	15
sturen	st:u::r:e:n|st:yː::r:ə:	10
stuur	st:uu:r|st:yː:r	28
stuurde	st:uu:r:d:e:|st:yː:r:d:ə:	4
stuurhut	st:uu:r:h:u:t|st:yː:r:h:ʉ:t	3
stuurman	st:uu:r:m:a:n|st:yː:r:m:ɑ:n	10
stuurt	st:uu:rt|st:yː:rt	12
succes	s:u:c:c:e:s|s:yː:k:s:ɛ:s	2
suf	s:u:f|s:ʉ:f	42
suiker	s:ui::k:e:r|s:œy::k:ə:r	19
suikerpot	s:ui::k:e:r:p:o:t|s:œy::k:ə:r:p:ɔ:t	2
suikerspin	s:ui::k:e:r:sp:i:n|s:œy::k:ə:r:sp:ɪ:n	2
suist	s:ui:st|s:œy:st	8
sukkel	s:u:k:k:e:l|s:ʉ::k:ə:l	3
sukkels	s:u:k:k:e:ls|s:ʉ::k:ə:ls	2
super	s:u::p:e:r|s:yː::p:ə:r	21
supermarkt	s:u::p:e:r:m:a:rkt|s:yː::p:ə:r:m:ɑ:rkt	2
surfplank	s:u:rf:pl:a:nk|s:ʉ:rf:pl:ɑ:ŋk	3
sust	s:u:st|s:ʉ:st	6
t	t::|t:eː:	196
taai	t:aa:i|t:aː:j	4
taaie	t:aa:i::e:|t:aː::j:ə:	2
taaitaai	t:aa:i:t:aa:i|t:aː:j:t:aː:j	2
taak	t:aa:k|t:aː:k	3
taal	t:aa:l|t:aː:l	26
taart	t:aa:rt|t:aː:rt	239
taarten	t:aa:r:t:e:n|t:aː:r:t:ə:	4
taartjes	t:aa:rt:j:e:s|t:aː:rt:j:ə:s	6
tachtig	t:a:ch:t:i:g|t:ɑ:ç:t:ə:ç	4
tafel	t:a::f:e:l|t:aː::f:ə:l	122
tafels	t:a::f:e:ls|t:aː::f:ə:ls	5
tafeltje	t:a::f:e:l:tj:e:|t:aː::f:ə:l:tj:ə:	8
tak	t:a:k|t:ɑ:k	242
takje	t:a:k:j:e:|t:ɑ:k:j:ə:	4
takjes	t:a:k:j:e:s|t:ɑ:k:j:ə:s	11
takken	t:a:k:k:e:n|t:ɑ::k:ə:	31
talen	t:a::l:e:n|t:aː::l:ə:	3
tam	t:a:m|t:ɑ:m	4
tand	t:a:nd|t:ɑ:nt	52
tanden	t:a:n:d:e:n|t:ɑ:n:d:ə:	61
tandjes	t:a:nd:j:e:s|t:ɑ:nt:j:ə:s	7
tang	t:a:ng|t:ɑ:ŋ	19
tante	t:a:n:t:e:|t:ɑ:n:t:ə:	212
tantes	t:a:n:t:e:s|t:ɑ:n:t:ə:s	3
tas	t:a:s|t:ɑ:s	188
tasje	t:a:s:j:e:|t:ɑ:s:j:ə:	5
tasjes	t:a:s:j:e:s|t:ɑ:s:j:ə:s	4
tassen	t:a:s:s:e:n|t:ɑ::s:ə:	12
tast	t:a:st|t:ɑ:st	2
te	t:e:|t:ə:	1351
teen	t:ee:n|t:eː:n	197
teer	t:ee:r|t:eː:r	8
teevee	t:ee::v:ee:|t:eː::v:eː:	15
tegelijk	t:e::g:e::l:ij:k|t:ə::ɣ:ə::l:ɛi:k	17
tegen	t:e::g:e:n|t:eː::ɣ:ə:	258
tegenhouden	t:e::g:e:n:h:ou::d:e:n|t:eː::ɣ:ə::h:ɑu::d:ə:	2
tegenover	t:e::g:e:n::o::v:e:r|t:eː::ɣ:ə:::oː::v:ə:r	5
teil	t:ei:l|t:ɛi:l	6
teken	t:e::k:e:n|t:eː::k:ə:	150
tekenaar	t:e::k:e::n:aa:r|t:eː::k:ə::n:aː:r	2
tekenblok	t:e::k:e:n:bl:o:k|t:eː::k:ə:m:bl:ɔ:k	2
tekenen	t:e::k:e::n:e:n|t:eː::k:ə::n:ə:	16
tekening	t:e::k:e::n:i:ng|t:eː::k:ə::n:ɪ:ŋ	17
tekeningen	t:e::k:e::n:i:n:g:e:n|t:eː::k:ə::n:ɪ::ŋ:ə:	92
tekent	t:e::k:e:nt|t:eː::k:ə:nt	12
tekst	t:e:kst|t:ɛ:kst	48
teksten	t:e:k:st:e:n|t:ɛ:ks:t:ə:	3
tel	t:e:l|t:ɛ:l	35
telefoon	t:e::l:e::f:oo:n|t:eː::l:ə::f:oː:n	16
teleurgesteld	t:e::l:eu:r:g:e::st:e:ld|t:ə::l:øː:r:ɣ:ə::st:ɛ:lt	5
televisie	t:e::l:e::v:i::s:ie:|t:eː::l:ə::v:iː::z:iː:	10
telkens	t:e:l:k:e:ns|t:ɛ:l:k:ə:ns	15
tellen	t:e:l:l:e:n|t:ɛ::l:ə:	15
telt	t:e:lt|t:ɛ:lt	30
tem	t:e:m|t:ɛ:m	49
temmer	t:e:m:m:e:r|t:ɛ::m:ə:r	3
temt	t:e:mt|t:ɛ:mt	3
ten	t:e:n|t:ɛ:n	10
tenen	t:e::n:e:n|t:eː::n:ə:	13
tenminste	t:e:n:m:i:n:st:e:|t:ɛ:n:m:ɪ:n:st:ə:	7
tennis	t:e:n:n:i:s|t:ɛ::n:ə:s	3
tent	t:e:nt|t:ɛ:nt	111
tentdoek	t:e:nt:d:oe:k|t:ɛ:n:d:uː:k	4
tenten	t:e:n:t:e:n|t:ɛ:n:t:ə:	6
tentstokken	t:e:nt:st:o:k:k:e:n|t:ɛ:nt:st:ɔ::k:ə:	2
ter	t:e:r|t:ɛ:r	7
terecht	t:e::r:e:cht|t:ə::r:ɛ:çt	10
terras	t:e:r:r:a:s|t:ɛ::r:ɑ:s	18
terug	t:e::r:u:g|t:ə::r:ʉ:ç	267
terugkom	t:e::r:u:g:k:o:m|t:ə::r:ʉ:ç:k:ɔ:m	3
terugkomen	t:e::r:u:g:k:o::m:e:n|t:ə::r:ʉ:ç:k:oː::m:ə:	2
terugkomt	t:e::r:u:g:k:o:mt|t:ə::r:ʉ:ç:k:ɔ:mt	8
terwijl	t:e:r:w:ij:l|t:ɛ:r:w:ɛi:l	17
test	t:e:st|t:ɛ:st	4
teugels	t:eu::g:e:ls|t:øː::ɣ:ə:ls	3
tevoorschijn	t:e::v:oo:r:sch:ij:n|t:ə::v:oː:r:sç:ɛi:n	4
tevreden	t:e::vr:e::d:e:n|t:ə::vr:eː::d:ə:	14
theater	th:e:::a::t:e:r|t:eː::j:aː::t:ə:r	3
thee	th:ee:|t:eː:	39
thuis	th:ui:s|t:œy:s	122
ticket	t:i:ck::e:t|t:ɪ::k:ə:t	2
tickets	t:i:ck::e:ts|t:ɪ::k:ə:ts	2
tien	t:ie:n|t:iː:n	182
tiert	t:ie:rt|t:iː:rt	9
tij	t:ij:|t:ɛi:	5
tijd	t:ij:d|t:ɛi:t	205
tijdens	t:ij::d:e:ns|t:ɛi::d:ə:ns	7
tijdje	t:ij:d:j:e:|t:ɛi:t:j:ə:	37
tijdschrift	t:ij:d:schr:i:ft|t:ɛi:t:sçr:ɪ:ft	7
tijger	t:ij::g:e:r|t:ɛi::ɣ:ə:r	36
tijgers	t:ij::g:e:rs|t:ɛi::ɣ:ə:rs	10
tik	t:i:k|t:ɪ:k	76
tikken	t:i:k:k:e:n|t:ɪ::k:ə:	4
tikkertje	t:i:k:k:e:r:tj:e:|t:ɪ::k:ə:r:tj:ə:	4
tikt	t:i:kt|t:ɪ:kt	37
til	t:i:l|t:ɪ:l	13
tilde	t:i:l:d:e:|t:ɪ:l:d:ə:	8
tillen	t:i:l:l:e:n|t:ɪ::l:ə:	10
tilt	t:i:lt|t:ɪ:lt	48
timmerdoos	t:i:m:m:e:r:d:oo:s|t:ɪ::m:ə:r:d:oː:s	2
timmeren	t:i:m:m:e::r:e:n|t:ɪ::m:ə::r:ə:	2
timmerman	t:i:m:m:e:r:m:a:n|t:ɪ::m:ə:r:m:ɑ:n	8
tip	t:i:p|t:ɪ:p	16
tips	t:i:ps|t:ɪ:ps	2
titel	t:i::t:e:l|t:iː::t:ə:l	21
titels	t:i::t:e:ls|t:iː::t:ə:ls	4
tja	tj:a:|tʃ:aː:	28
tjoep	tj:oe:p|tʃ:uː:p	8
tjonge	tj:o:n:g:e:|tʃ:ɔ::ŋ:ə:	6
tobbe	t:o:b:b:e:|t:ɔ::b:ə:	2
toch	t:o:ch|t:ɔ:ç	593
tocht	t:o:cht|t:ɔ:çt	21
toe	t:oe:|t:uː:	312
toegang	t:oe::g:a:ng|t:uː::ɣ:ɑ:ŋ	11
toekomst	t:oe::k:o:mst|t:uː::k:ɔ:mst	2
toen	t:oe:n|t:uː:n	272
toer	t:oe:r|t:uː:r	13
toestel	t:oe::st:e:l|t:uː::st:ɛ:l	5
toet	t:oe:t|t:uː:t	13
toeter	t:oe::t:e:r|t:uː::t:ə:r	3
toeteren	t:oe::t:e::r:e:n|t:uː::t:ə::r:ə:	8
toetje	t:oe::tj:e:|t:uː::tj:ə:	8
toets	t:oe:ts|t:uː:ts	3
toevallig	t:oe::v:a:l:l:i:g|t:uː::v:ɑ::l:ə:ç	10
tof	t:o:f|t:ɔ:f	5
tok	t:o:k|t:ɔ:k	70
tokt	t:o:kt|t:ɔ:kt	2
tol	t:o:l|t:ɔ:l	4
tollen	t:o:l:l:e:n|t:ɔ::l:ə:	2
tolletje	t:o:l:l:e::tj:e:|t:ɔ::l:ə::tj:ə:	2
ton	t:o:n|t:ɔ:n	22
toneel	t:o::n:ee:l|t:oː::n:eː:l	9
toneelstuk	t:o::n:ee:l:st:u:k|t:oː::n:eː:l:st:ʉ:k	4
tonen	t:o::n:e:n|t:oː::n:ə:	6
tong	t:o:ng|t:ɔ:ŋ	56
tongetje	t:o:n:g:e::tj:e:|t:ɔ::ŋ:ə::tj:ə:	6
tonijn	t:o::n:ij:n|t:oː::n:ɛi:n	7
tonnetje	t:o:n:n:e::tj:e:|t:ɔ::n:ə::tj:ə:	2
tooi	t:oo:i|t:oː:j	7
toon	t:oo:n|t:oː:n	157
toont	t:oo:nt|t:oː:nt	3
top	t:o:p|t:ɔ:p	39
toppen	t:o:p:p:e:n|t:ɔ::p:ə:	2
tor	t:o:r|t:ɔ:r	44
toren	t:o::r:e:n|t:oː::r:ə:	32
torens	t:o::r:e:ns|t:oː::r:ə:ns	5
torren	t:o:r:r:e:n|t:ɔ::r:ə:	2
torretje	t:o:r:r:e::tj:e:|t:ɔ::r:ə::tj:ə:	2
tot	t:o:t|t:ɔ:t	313
totaal	t:o::t:aa:l|t:oː::t:aː:l	3
totdat	t:o:t:d:a:t|t:ɔ::d:ɑ:t	14
touw	t:ou:w|t:ɑu:w	177
touwen	t:ou::w:e:n|t:ɑu::w:ə:	6
touwtje	t:ou:w:tj:e:|t:ɑu:w:tj:ə:	9
touwtjes	t:ou:w:tj:e:s|t:ɑu:w:tj:ə:s	2
tover	t:o::v:e:r|t:oː::v:ə:r	9
toverde	t:o::v:e:r:d:e:|t:oː::v:ə:r:d:ə:	3
toveren	t:o::v:e::r:e:n|t:oː::v:ə::r:ə:	12
toverspreuk	t:o::v:e:r:spr:eu:k|t:oː::v:ə:r:spr:øː:k	8
tovert	t:o::v:e:rt|t:oː::v:ə:rt	7
tra	tr:a:|tr:aː:	2
traag	tr:aa:g|tr:aː:ç	13
traan	tr:aa:n|tr:aː:n	43
trager	tr:a::g:e:r|tr:aː::ɣ:ə:r	2
tram	tr:a:m|tr:ɑ:m	6
trams	tr:a:ms|tr:ɑ:ms	2
tranen	tr:a::n:e:n|tr:aː::n:ə:	29
trap	tr:a:p|tr:ɑ:p	119
trappelt	tr:a:p:p:e:lt|tr:ɑ::p:ə:lt	2
trappen	tr:a:p:p:e:n|tr:ɑ::p:ə:	11
trappers	tr:a:p:p:e:rs|tr:ɑ::p:ə:rs	2
trapt	tr:a:pt|tr:ɑ:pt	14
trapte	tr:a:p:t:e:|tr:ɑ:p:t:ə:	2
tree	tr:ee:|tr:eː:	3
treed	tr:ee:d|tr:eː:t	6
treedt	tr:ee:dt|tr:eː:t	6
trees	tr:ee:s|tr:eː:s	38
trein	tr:ei:n|tr:ɛi:n	110
treinen	tr:ei::n:e:n|tr:ɛi::n:ə:	19
treintje	tr:ei:n:tj:e:|tr:ɛi:n:tj:ə:	2
trek	tr:e:k|tr:ɛ:k	95
trekken	tr:e:k:k:e:n|tr:ɛ::k:ə:	16
trekt	tr:e:kt|tr:ɛ:kt	215
trekvogel	tr:e:k:v:o::g:e:l|tr:ɛ:k:f:oː::ɣ:ə:l	2
treurig	tr:eu::r:i:g|tr:øː::r:ə:ç	17
treuzelen	tr:eu::z:e::l:e:n|tr:øː::z:ə::l:ə:	3
triest	tr:ie:st|tr:iː:st	5
tril	tr:i:l|tr:ɪ:l	4
trillen	tr:i:l:l:e:n|tr:ɪ::l:ə:	12
trillend	tr:i:l:l:e:nd|tr:ɪ::l:ə:nt	3
trilt	tr:i:lt|tr:ɪ:lt	24
trippelt	tr:i:p:p:e:lt|tr:ɪ::p:ə:lt	2
troep	tr:oe:p|tr:uː:p	37
trok	tr:o:k|tr:ɔ:k	12
trokken	tr:o:k:k:e:n|tr:ɔ::k:ə:	3
trol	tr:o:l|tr:ɔ:l	46
trom	tr:o:m|tr:ɔ:m	22
trommel	tr:o:m:m:e:l|tr:ɔ::m:ə:l	13
trommelen	tr:o:m:m:e::l:e:n|tr:ɔ::m:ə::l:ə:	5
trommels	tr:o:m:m:e:ls|tr:ɔ::m:ə:ls	8
trommelt	tr:o:m:m:e:lt|tr:ɔ::m:ə:lt	4
trompet	tr:o:m:p:e:t|tr:ɔ:m:p:ɛ:t	7
troon	tr:oo:n|tr:oː:n	29
troost	tr:oo:st|tr:oː:st	6
troosten	tr:oo:s:t:e:n|tr:oː:s:t:ə:	8
tros	tr:o:s|tr:ɔ:s	3
trots	tr:o:ts|tr:ɔ:ts	87
trouw	tr:ou:w|tr:ɑu:w	5
trouwde	tr:ou:w:d:e:|tr:ɑu:w:d:ə:	2
trouwe	tr:ou::w:e:|tr:ɑu::w:ə:	5
trouwen	tr:ou::w:e:n|tr:ɑu::w:ə:	10
trouwens	tr:ou::w:e:ns|tr:ɑu::w:ə:ns	14
truc	tr:u:c|tr:yː:k	2
trucs	tr:u:cs|tr:yː:ks	3
trui	tr:ui:|tr:œy:	61
truien	tr:ui:::e:n|tr:œy::j:ə:	3
truitje	tr:ui::tj:e:|tr:œy::tj:ə:	2
tuimelt	t:ui::m:e:lt|t:œy::m:ə:lt	4
tuin	t:ui:n|t:œy:n	358
tuinbank	t:ui:n:b:a:nk|t:œy:m:b:ɑ:ŋk	3
tuinen	t:ui::n:e:n|t:œy::n:ə:	9
tuinman	t:ui:n:m:a:n|t:œy:n:m:ɑ:n	16
tuinpad	t:ui:n:p:a:d|t:œy:m:p:ɑ:t	12
tuinslang	t:ui:n:sl:a:ng|t:œy:n:sl:ɑ:ŋ	4
tuinstoel	t:ui:n:st:oe:l|t:œy:n:st:uː:l	4
tuintje	t:ui:n:tj:e:|t:œy:n:tj:ə:	2
tuit	t:ui:t|t:œy:t	2
tulp	t:u:lp|t:ʉ:lp	11
tulpen	t:u:l:p:e:n|t:ʉ:l:p:ə:	2
turen	t:u::r:e:n|t:yː::r:ə:	9
tussen	t:u:s:s:e:n|t:ʉ::s:ə:	72
tussendoor	t:u:s:s:e:n:d:oo:r|t:ʉ::s:ə::d:oː:r	2
tussenin	t:u:s:s:e:n::i:n|t:ʉ::s:ə:::ɪ:n	3
tuur	t:uu:r|t:yː:r	2
tuurt	t:uu:rt|t:yː:rt	34
tuut	t:uu:t|t:yː:t	101
twaalf	tw:aa:lf|tw:aː:lf	26
twee	tw:ee:|tw:eː:	447
tweede	tw:ee::d:e:|tw:eː::d:ə:	31
tweeling	tw:ee::l:i:ng|tw:eː::l:ɪ:ŋ	15
twijfelen	tw:ij::f:e::l:e:n|tw:ɛi::f:ə::l:ə:	2
twijfelt	tw:ij::f:e:lt|tw:ɛi::f:ə:lt	4
twintig	tw:i:n:t:i:g|tw:ɪ:n:t:ə:ç	14
u	:u:|:yː:	344
ui	:ui:|:œy:	20
uier	:ui:::e:r|:œy::j:ə:r	3
uil	:ui:l|:œy:l	162
uilen	:ui::l:e:n|:œy::l:ə:	12
uit	:ui:t|:œy:t	1769
uitdoen	:ui:t:d:oe:n|:œy::d:uː:n	2
uiteindelijk	:ui:t::ei:n:d:e::l:ij:k|:œy:t::ɛi:n:d:ə::l:ə:k	4
uitgaan	:ui:t:g:aa:n|:œy:t:ç:aː:n	3
uitgang	:ui:t:g:a:ng|:œy:t:ç:ɑ:ŋ	23
uitgekozen	:ui:t:g:e::k:o::z:e:n|:œy:t:ç:ə::k:oː::z:ə:	2
uitgenodigd	:ui:t:g:e::n:o::d:i:gd|:œy:t:ç:ə::n:oː::d:ə:çt	2
uitgeput	:ui:t:g:e::p:u:t|:œy:t:ç:ə::p:ʉ:t	2
uitgeven	:ui:t:g:e::v:e:n|:œy:t:ç:eː::v:ə:	6
uitgeverij	:ui:t:g:e::v:e::r:ij:|:œy:t:ç:eː::v:ə::r:ɛi:	2
uitgevonden	:ui:t:g:e::v:o:n:d:e:n|:œy:t:ç:ə::v:ɔ:n:d:ə:	2
uitje	:ui::tj:e:|:œy::tj:ə:	4
uitje	:ui:t:j:e:|:œy:t:j:ə:	4
uitjes	:ui::tj:e:s|:œy::tj:ə:s	4
uitjes	:ui:t:j:e:s|:œy:t:j:ə:s	4
uitkiezen	:ui:t:k:ie::z:e:n|:œy:t:k:iː::z:ə:	4
uitkijken	:ui:t:k:ij::k:e:n|:œy:t:k:ɛi::k:ə:	11
uitkleden	:ui:t:kl:e::d:e:n|:œy:t:kl:eː::d:ə:	3
uitlaten	:ui:t:l:a::t:e:n|:œy:t:l:aː::t:ə:	6
uitleggen	:ui:t:l:e:g:g:e:n|:œy:t:l:ɛ::ɣ:ə:	7
uitpakken	:ui:t:p:a:k:k:e:n|:œy:t:p:ɑ::k:ə:	3
uitrusten	:ui:t:r:u:s:t:e:n|:œy:t:r:ʉ:s:t:ə:	5
uitstappen	:ui:t:st:a:p:p:e:n|:œy:t:st:ɑ::p:ə:	3
uitsteken	:ui:t:st:e::k:e:n|:œy:t:st:eː::k:ə:	2
uitvoeren	:ui:t:v:oe::r:e:n|:œy:t:f:uː::r:ə:	7
uitzicht	:ui:t:z:i:cht|:œy:t:s:ɪ:çt	5
uitzie	:ui:t:z:ie:|:œy:t:s:iː:	2
uitzien	:ui:t:z:ie:n|:œy:t:s:iː:n	2
uitziet	:ui:t:z:ie:t|:œy:t:s:iː:t	5
uitzoeken	:ui:t:z:oe::k:e:n|:œy:t:s:uː::k:ə:	10
uniform	:u::n:i::f:o:rm|:yː::n:iː::f:ɔ:rm	3
uren	:u::r:e:n|:yː::r:ə:	9
uur	:uu:r|:yː:r	207
uurtje	:uu:r:tj:e:|:yː:r:tj:ə:	9
uurtjes	:uu:r:tj:e:s|:yː:r:tj:ə:s	2
uw	:u:w|:yː:w	64
v	v::|v:eː:	376
va	v:a:|v:aː:	25
vaag	v:aa:g|v:aː:ç	2
vaak	v:aa:k|v:aː:k	212
vaan	v:aa:n|v:aː:n	3
vaar	v:aa:r|v:aː:r	254
vaart	v:aa:rt|v:aː:rt	91
vaas	v:aa:s|v:aː:s	194
vaat	v:aa:t|v:aː:t	12
vacht	v:a:cht|v:ɑ:çt	42
vader	v:a::d:e:r|v:aː::d:ə:r	206
vaders	v:a::d:e:rs|v:aː::d:ə:rs	11
vak	v:a:k|v:ɑ:k	25
vakantie	v:a::k:a:n:t:ie:|v:aː::k:ɑ:n:s:iː:	63
vaker	v:a::k:e:r|v:aː::k:ə:r	5
vakjes	v:a:k:j:e:s|v:ɑ:k:j:ə:s	5
val	v:a:l|v:ɑ:l	71
vallen	v:a:l:l:e:n|v:ɑ::l:ə:	51
vals	v:a:ls|v:ɑ:ls	33
valt	v:a:lt|v:ɑ:lt	216
van	v:a:n|v:ɑ:n	4667
vanaf	v:a:n::a:f|v:ɑ:n::ɑ:f	19
vanavond	v:a:n::a::v:o:nd|v:ɑ:n::aː::v:ɔ:nt	11
vandaag	v:a:n:d:aa:g|v:ɑ:n:d:aː:ç	128
vandaan	v:a:n:d:aa:n|v:ɑ:n:d:aː:n	43
vandaar	v:a:n:d:aa:r|v:ɑ:n:d:aː:r	3
vandoor	v:a:n:d:oo:r|v:ɑ:n:d:oː:r	8
vang	v:a:ng|v:ɑ:ŋ	15
vangen	v:a:n:g:e:n|v:ɑ::ŋ:ə:	25
vangt	v:a:ngt|v:ɑ:ŋt	17
vanmiddag	v:a:n:m:i:d:d:a:g|v:ɑ:n:m:ɪ::d:ɑ:ç	4
vanmorgen	v:a:n:m:o:r:g:e:n|v:ɑ:n:m:ɔ:r:ɣ:ə:	2
vannacht	v:a:n:n:a:cht|v:ɑ::n:ɑ:çt	16
vanochtend	v:a:n::o:ch:t:e:nd|v:ɑ:n::ɔ:ç:t:ə:nt	2
vanuit	v:a:n::ui:t|v:ɑ:n::œy:t	5
vanzelf	v:a:n:z:e:lf|v:ɑ:n:z:ɛ:lf	31
varen	v:a::r:e:n|v:aː::r:ə:	38
varken	v:a:r:k:e:n|v:ɑ:r:k:ə:	27
varkens	v:a:r:k:e:ns|v:ɑ:r:k:ə:ns	3
varkentje	v:a:r:k:e:n:tj:e:|v:ɑ:r:k:ə:n:tj:ə:	14
vast	v:a:st|v:ɑ:st	435
vastbinden	v:a:st:b:i:n:d:e:n|v:ɑ:zd:b:ɪ:n:d:ə:	3
vaste	v:a:s:t:e:|v:ɑ:s:t:ə:	2
vasthouden	v:a:st:h:ou::d:e:n|v:ɑ:st:h:ɑu::d:ə:	8
vastmaken	v:a:st:m:a::k:e:n|v:ɑ:st:m:aː::k:ə:	3
vastzitten	v:a:st:z:i:t:t:e:n|v:ɑ:st:s:ɪ::t:ə:	4
vaten	v:a::t:e:n|v:aː::t:ə:	2
vatten	v:a:t:t:e:n|v:ɑ::t:ə:	2
vazen	v:a::z:e:n|v:aː::z:ə:	3
vecht	v:e:cht|v:ɛ:çt	21
vechten	v:e:ch:t:e:n|v:ɛ:ç:t:ə:	16
vechtend	v:e:ch:t:e:nd|v:ɛ:ç:t:ə:nt	2
vee	v:ee:|v:eː:	57
veeg	v:ee:g|v:eː:ç	13
veegt	v:ee:gt|v:eː:çt	53
veel	v:ee:l|v:eː:l	802
veer	v:ee:r|v:eː:r	222
veert	v:ee:rt|v:eː:rt	6
veertien	v:ee:r:t:ie:n|v:eː:r:t:iː:n	12
veertig	v:ee:r:t:i:g|v:eː:r:t:ə:ç	5
veertje	v:ee:r:tj:e:|v:eː:r:tj:ə:	5
veertjes	v:ee:r:tj:e:s|v:eː:r:tj:ə:s	2
vegen	v:e::g:e:n|v:eː::ɣ:ə:	8
veger	v:e::g:e:r|v:eː::ɣ:ə:r	3
veilig	v:ei::l:i:g|v:ɛi::l:ə:ç	47
vel	v:e:l|v:ɛ:l	103
veld	v:e:ld|v:ɛ:lt	45
velden	v:e:l:d:e:n|v:ɛ:l:d:ə:	9
velletje	v:e:l:l:e::tj:e:|v:ɛ::l:ə::tj:ə:	12
ven	v:e:n|v:ɛ:n	13
vensterbank	v:e:n:st:e:r:b:a:nk|v:ɛ:n:st:ə:r:b:ɑ:ŋk	5
vent	v:e:nt|v:ɛ:nt	5
ver	v:e:r|v:ɛ:r	276
veranderd	v:e:r::a:n:d:e:rd|v:ə:r::ɑ:n:d:ə:rt	4
verandert	v:e:r::a:n:d:e:rt|v:ə:r::ɑ:n:d:ə:rt	3
verbaasd	v:e:r:b:aa:sd|v:ə:r:b:aː:st	82
verband	v:e:r:b:a:nd|v:ə:r:b:ɑ:nt	6
verboden	v:e:r:b:o::d:e:n|v:ə:r:b:oː::d:ə:	22
verbrandt	v:e:r:br:a:ndt|v:ə:r:br:ɑ:nt	3
verdeelt	v:e:r:d:ee:lt|v:ə:r:d:eː:lt	2
verder	v:e:r:d:e:r|v:ɛ:r:d:ə:r	174
verderop	v:e:r:d:e:r::o:p|v:ɛ:r:d:ə:r::ɔ:p	5
verdien	v:e:r:d:ie:n|v:ə:r:d:iː:n	2
verdiend	v:e:r:d:ie:nd|v:ə:r:d:iː:nt	4
verdienen	v:e:r:d:ie::n:e:n|v:ə:r:d:iː::n:ə:	2
verdraag	v:e:r:dr:aa:g|v:ə:r:dr:aː:ç	3
verdriet	v:e:r:dr:ie:t|v:ə:r:dr:iː:t	14
verdrietig	v:e:r:dr:ie::t:i:g|v:ə:r:dr:iː::t:ə:ç	27
verdrink	v:e:r:dr:i:nk|v:ə:r:dr:ɪ:ŋk	2
verdrinken	v:e:r:dr:i:n:k:e:n|v:ə:r:dr:ɪ:ŋ:k:ə:	2
verdwaald	v:e:r:dw:aa:ld|v:ə:r:dw:aː:lt	21
verdwalen	v:e:r:dw:a::l:e:n|v:ə:r:dw:aː::l:ə:	14
verdween	v:e:r:dw:ee:n|v:ə:r:dw:eː:n	4
verdwenen	v:e:r:dw:e::n:e:n|v:ə:r:dw:eː::n:ə:	10
verdwijnen	v:e:r:dw:ij::n:e:n|v:ə:r:dw:ɛi::n:ə:	5
verdwijnt	v:e:r:dw:ij:nt|v:ə:r:dw:ɛi:nt	8
veren	v:e::r:e:n|v:eː::r:ə:	16
verf	v:e:rf|v:ɛ:rf	58
verfdoos	v:e:rf:d:oo:s|v:ɛ:rv:d:oː:s	4
verfkwast	v:e:rf:kw:a:st|v:ɛ:rf:kw:ɑ:st	3
verfpot	v:e:rf:p:o:t|v:ɛ:rf:p:ɔ:t	2
verft	v:e:rft|v:ɛ:rft	18
vergaat	v:e:r:g:aa:t|v:ə:r:ɣ:aː:t	2
vergat	v:e:r:g:a:t|v:ə:r:ɣ:ɑ:t	9
vergaten	v:e:r:g:a::t:e:n|v:ə:r:ɣ:aː::t:ə:	3
vergeet	v:e:r:g:ee:t|v:ə:r:ɣ:eː:t	42
vergeten	v:e:r:g:e::t:e:n|v:ə:r:ɣ:eː::t:ə:	52
vergiet	v:e:r:g:ie:t|v:ə:r:ɣ:iː:t	2
vergis	v:e:r:g:i:s|v:ə:r:ɣ:ɪ:s	3
vergist	v:e:r:g:i:st|v:ə:r:ɣ:ɪ:st	8
vergrootglas	v:e:r:gr:oo:t:gl:a:s|v:ə:r:ɣr:oː:t:çl:ɑ:s	4
vergunning	v:e:r:g:u:n:n:i:ng|v:ə:r:ɣ:ʉ::n:ɪ:ŋ	3
verhaal	v:e:r:h:aa:l|v:ə:r:h:aː:l	212
verhaaltje	v:e:r:h:aa:l:tj:e:|v:ə:r:h:aː:l:tj:ə:	3
verhaaltjes	v:e:r:h:aa:l:tj:e:s|v:ə:r:h:aː:l:tj:ə:s	2
verhalen	v:e:r:h:a::l:e:n|v:ə:r:h:aː::l:ə:	35
verhuis	v:e:r:h:ui:s|v:ə:r:h:œy:s	8
verhuisd	v:e:r:h:ui:sd|v:ə:r:h:œy:st	5
verhuist	v:e:r:h:ui:st|v:ə:r:h:œy:st	3
verhuizen	v:e:r:h:ui::z:e:n|v:ə:r:h:œy::z:ə:	7
verjaagd	v:e:r:j:aa:gd|v:ə:r:j:aː:çt	3
verjaardag	v:e:r:j:aa:r:d:a:g|v:ə:r:j:aː:r:d:ɑ:ç	24
verkeer	v:e:r:k:ee:r|v:ə:r:k:eː:r	7
verkeerd	v:e:r:k:ee:rd|v:ə:r:k:eː:rt	7
verkleed	v:e:r:kl:ee:d|v:ə:r:kl:eː:t	4
verkocht	v:e:r:k:o:cht|v:ə:r:k:ɔ:çt	3
verkoop	v:e:r:k:oo:p|v:ə:r:k:oː:p	3
verkoop	v:e:r:k:oo:p|v:ɛ:r:k:oː:p	3
verkoopt	v:e:r:k:oo:pt|v:ə:r:k:oː:pt	5
verkopen	v:e:r:k:o::p:e:n|v:ə:r:k:oː::p:ə:	13
verkopen	v:e:r:k:o::p:e:n|v:ɛ:r:k:oː::p:ə:	13
verkouden	v:e:r:k:ou::d:e:n|v:ə:r:k:ɑu::d:ə:	5
verlaat	v:e:r:l:aa:t|v:ə:r:l:aː:t	3
verlaten	v:e:r:l:a::t:e:n|v:ə:r:l:aː::t:ə:	4
verlegen	v:e:r:l:e::g:e:n|v:ə:r:l:eː::ɣ:ə:	12
verlicht	v:e:r:l:i:cht|v:ə:r:l:ɪ:çt	2
verliefd	v:e:r:l:ie:fd|v:ə:r:l:iː:ft	14
verlies	v:e:r:l:ie:s|v:ə:r:l:iː:s	5
verliest	v:e:r:l:ie:st|v:ə:r:l:iː:st	4
verliezen	v:e:r:l:ie::z:e:n|v:ə:r:l:iː::z:ə:	13
verloren	v:e:r:l:o::r:e:n|v:ə:r:l:oː::r:ə:	11
vermaken	v:e:r:m:a::k:e:n|v:ə:r:m:aː::k:ə:	7
vermoorden	v:e:r:m:oo:r:d:e:n|v:ə:r:m:oː:r:d:ə:	2
verpakt	v:e:r:p:a:kt|v:ə:r:p:ɑ:kt	5
verpest	v:e:r:p:e:st|v:ə:r:p:ɛ:st	3
verraad	v:e:r:r:aa:d|v:ə::r:aː:t	2
verrassen	v:e:r:r:a:s:s:e:n|v:ə::r:ɑ::s:ə:	2
verrassing	v:e:r:r:a:s:s:i:ng|v:ə::r:ɑ::s:ɪ:ŋ	22
verrast	v:e:r:r:a:st|v:ə::r:ɑ:st	4
verre	v:e:r:r:e:|v:ɛ::r:ə:	14
verrekijker	v:e:r:r:e::k:ij::k:e:r|v:ɛ::r:ə::k:ɛi::k:ə:r	8
vers	v:e:rs|v:ɛ:rs	36
verschenen	v:e:r:sch:e::n:e:n|v:ə:r:sç:eː::n:ə:	5
verschijnen	v:e:r:sch:ij::n:e:n|v:ə:r:sç:ɛi::n:ə:	5
verschijnt	v:e:r:sch:ij:nt|v:ə:r:sç:ɛi:nt	3
verschil	v:e:r:sch:i:l|v:ə:r:sç:ɪ:l	11
verschillen	v:e:r:sch:i:l:l:e:n|v:ə:r:sç:ɪ::l:ə:	3
verschillend	v:e:r:sch:i:l:l:e:nd|v:ə:r:sç:ɪ::l:ə:nt	4
verschillende	v:e:r:sch:i:l:l:e:n:d:e:|v:ə:r:sç:ɪ::l:ə:n:d:ə:	3
verschrikkelijk	v:e:r:schr:i:k:k:e::l:ij:k|v:ə:r:sçr:ɪ::k:ə::l:ə:k	6
verschrikt	v:e:r:schr:i:kt|v:ə:r:sçr:ɪ:kt	10
verse	v:e:r:s:e:|v:ɛ:r:s:ə:	6
versier	v:e:r:s:ie:r|v:ə:r:s:iː:r	4
versierd	v:e:r:s:ie:rd|v:ə:r:s:iː:rt	9
versieren	v:e:r:s:ie::r:e:n|v:ə:r:s:iː::r:ə:	5
versiert	v:e:r:s:ie:rt|v:ə:r:s:iː:rt	5
verslag	v:e:r:sl:a:g|v:ə:r:sl:ɑ:ç	3
verst	v:e:rst|v:ɛ:rst	6
versta	v:e:r:st:a:|v:ə:r:st:aː:	3
verstaan	v:e:r:st:aa:n|v:ə:r:st:aː:n	2
verstaat	v:e:r:st:aa:t|v:ə:r:st:aː:t	5
verstand	v:e:r:st:a:nd|v:ə:r:st:ɑ:nt	2
verstandig	v:e:r:st:a:n:d:i:g|v:ə:r:st:ɑ:n:d:ə:ç	2
verstop	v:e:r:st:o:p|v:ə:r:st:ɔ:p	3
verstoppen	v:e:r:st:o:p:p:e:n|v:ə:r:st:ɔ::p:ə:	6
verstopt	v:e:r:st:o:pt|v:ə:r:st:ɔ:pt	26
verstopte	v:e:r:st:o:p:t:e:|v:ə:r:st:ɔ:p:t:ə:	2
verte	v:e:r:t:e:|v:ɛ:r:t:ə:	34
vertel	v:e:r:t:e:l|v:ə:r:t:ɛ:l	58
verteld	v:e:r:t:e:ld|v:ə:r:t:ɛ:lt	14
vertelde	v:e:r:t:e:l:d:e:|v:ə:r:t:ɛ:l:d:ə:	12
vertellen	v:e:r:t:e:l:l:e:n|v:ə:r:t:ɛ::l:ə:	33
vertelt	v:e:r:t:e:lt|v:ə:r:t:ɛ:lt	90
vertrek	v:e:r:tr:e:k|v:ə:r:tr:ɛ:k	4
vertrekken	v:e:r:tr:e:k:k:e:n|v:ə:r:tr:ɛ::k:ə:	5
vertrekt	v:e:r:tr:e:kt|v:ə:r:tr:ɛ:kt	9
vertrok	v:e:r:tr:o:k|v:ə:r:tr:ɔ:k	2
vertrouwt	v:e:r:tr:ou:wt|v:ə:r:tr:ɑu:wt	2
verveel	v:e:r:v:ee:l|v:ə:r:v:eː:l	11
verveelde	v:e:r:v:ee:l:d:e:|v:ə:r:v:eː:l:d:ə:	2
verveelt	v:e:r:v:ee:lt|v:ə:r:v:eː:lt	18
vervelen	v:e:r:v:e::l:e:n|v:ə:r:v:eː::l:ə:	11
vervelend	v:e:r:v:e::l:e:nd|v:ə:r:v:eː::l:ə:nt	3
verven	v:e:r:v:e:n|v:ɛ:r:v:ə:	10
vervoer	v:e:r:v:oe:r|v:ə:r:v:uː:r	6
vervolgt	v:e:r:v:o:lgt|v:ə:r:v:ɔ:lçt	3
verwacht	v:e:r:w:a:cht|v:ə:r:w:ɑ:çt	6
verwachting	v:e:r:w:a:ch:t:i:ng|v:ə:r:w:ɑ:ç:t:ɪ:ŋ	2
verwarmt	v:e:r:w:a:rmt|v:ə:r:w:ɑ:rmt	5
verwend	v:e:r:w:e:nd|v:ə:r:w:ɛ:nt	4
verwent	v:e:r:w:e:nt|v:ə:r:w:ɛ:nt	2
verzamel	v:e:r:z:a::m:e:l|v:ə:r:z:aː::m:ə:l	3
verzameld	v:e:r:z:a::m:e:ld|v:ə:r:z:aː::m:ə:lt	4
verzamelen	v:e:r:z:a::m:e::l:e:n|v:ə:r:z:aː::m:ə::l:ə:	5
verzamelt	v:e:r:z:a::m:e:lt|v:ə:r:z:aː::m:ə:lt	3
verzet	v:e:r:z:e:t|v:ə:r:z:ɛ:t	2
verzin	v:e:r:z:i:n|v:ə:r:z:ɪ:n	18
verzinnen	v:e:r:z:i:n:n:e:n|v:ə:r:z:ɪ::n:ə:	16
verzint	v:e:r:z:i:nt|v:ə:r:z:ɪ:nt	10
verzonnen	v:e:r:z:o:n:n:e:n|v:ə:r:z:ɔ::n:ə:	3
verzorgt	v:e:r:z:o:rgt|v:ə:r:z:ɔ:rçt	2
vest	v:e:st|v:ɛ:st	12
vet	v:e:t|v:ɛ:t	47
veter	v:e::t:e:r|v:eː::t:ə:r	5
vette	v:e:t:t:e:|v:ɛ::t:ə:	7
veulen	v:eu::l:e:n|v:øː::l:ə:	3
viel	v:ie:l|v:iː:l	52
vielen	v:ie::l:e:n|v:iː::l:ə:	4
vier	v:ie:r|v:iː:r	160
vierde	v:ie:r:d:e:|v:iː:r:d:ə:	6
vieren	v:ie::r:e:n|v:iː::r:ə:	4
vierkant	v:ie:r:k:a:nt|v:iː:r:k:ɑ:nt	2
vierkante	v:ie:r:k:a:n:t:e:|v:iː:r:k:ɑ:n:t:ə:	3
viert	v:ie:rt|v:iː:rt	2
vies	v:ie:s|v:iː:s	92
viespeuk	v:ie:s:p:eu:k|v:iː:s:p:øː:k	5
vieze	v:ie::z:e:|v:iː::z:ə:	27
vijand	v:ij:::a:nd|v:ɛi::j:ɑ:nt	6
vijf	v:ij:f|v:ɛi:f	100
vijfde	v:ij:f:d:e:|v:ɛi:v:d:ə:	2
vijftien	v:ij:f:t:ie:n|v:ɛi:f:t:iː:n	5
vijftig	v:ij:f:t:i:g|v:ɛi:f:t:ə:ç	4
vijl	v:ij:l|v:ɛi:l	2
vijver	v:ij::v:e:r|v:ɛi::v:ə:r	32
viltstift	v:i:lt:st:i:ft|v:ɪ:lt:st:ɪ:ft	2
vin	v:i:n|v:ɪ:n	34
vind	v:i:nd|v:ɪ:nt	226
vinden	v:i:n:d:e:n|v:ɪ:n:d:ə:	133
vindt	v:i:ndt|v:ɪ:nt	281
ving	v:i:ng|v:ɪ:ŋ	6
vinger	v:i:n:g:e:r|v:ɪ::ŋ:ə:r	20
vingers	v:i:n:g:e:rs|v:ɪ::ŋ:ə:rs	28
vink	v:i:nk|v:ɪ:ŋk	18
viool	v:i:::oo:l|v:iː::j:oː:l	7
vis	v:i:s|v:ɪ:s	560
visje	v:i:s:j:e:|v:ɪ:s:j:ə:	3
visjes	v:i:s:j:e:s|v:ɪ:s:j:ə:s	5
visnet	v:i:s:n:e:t|v:ɪ:s:n:ɛ:t	7
vissen	v:i:s:s:e:n|v:ɪ::s:ə:	40
visser	v:i:s:s:e:r|v:ɪ::s:ə:r	11
vissers	v:i:s:s:e:rs|v:ɪ::s:ə:rs	2
vist	v:i:st|v:ɪ:st	27
vizier	v:i::z:ie:r|v:iː::z:iː:r	5
vla	vl:a:|vl:aː:	34
vlag	vl:a:g|vl:ɑ:ç	58
vlaggen	vl:a:g:g:e:n|vl:ɑ::ɣ:ə:	7
vlaggetjes	vl:a:g:g:e::tj:e:s|vl:ɑ::ɣ:ə::tj:ə:s	5
vlak	vl:a:k|vl:ɑ:k	66
vlam	vl:a:m|vl:ɑ:m	8
vlammen	vl:a:m:m:e:n|vl:ɑ::m:ə:	6
vlecht	vl:e:cht|vl:ɛ:çt	15
vleermuis	vl:ee:r:m:ui:s|vl:eː:r:m:œy:s	10
vlees	vl:ee:s|vl:eː:s	31
vlek	vl:e:k|vl:ɛ:k	12
vlekken	vl:e:k:k:e:n|vl:ɛ::k:ə:	2
vleugel	vl:eu::g:e:l|vl:øː::ɣ:ə:l	18
vleugels	vl:eu::g:e:ls|vl:øː::ɣ:ə:ls	28
vlieg	vl:ie:g|vl:iː:ç	41
vliegen	vl:ie::g:e:n|vl:iː::ɣ:ə:	142
vliegende	vl:ie::g:e:n:d:e:|vl:iː::ɣ:ə:n:d:ə:	2
vlieger	vl:ie::g:e:r|vl:iː::ɣ:ə:r	44
vliegeren	vl:ie::g:e::r:e:n|vl:iː::ɣ:ə::r:ə:	5
vliegers	vl:ie::g:e:rs|vl:iː::ɣ:ə:rs	14
vliegles	vl:ie:g:l:e:s|vl:iː:ɣ:l:ɛ:s	2
vliegt	vl:ie:gt|vl:iː:çt	111
vliegtuig	vl:ie:g:t:ui:g|vl:iː:ç:t:œy:ç	100
vliegtuigen	vl:ie:g:t:ui::g:e:n|vl:iː:ç:t:œy::ɣ:ə:	7
vliegveld	vl:ie:g:v:e:ld|vl:iː:ç:f:ɛ:lt	27
vliet	vl:ie:t|vl:iː:t	3
vliezen	vl:ie::z:e:n|vl:iː::z:ə:	2
vlinder	vl:i:n:d:e:r|vl:ɪ:n:d:ə:r	26
vlinders	vl:i:n:d:e:rs|vl:ɪ:n:d:ə:rs	7
vlo	vl:o:|vl:oː:	10
vloed	vl:oe:d|vl:uː:t	9
vloei	vl:oe:i|vl:uː:j	7
vloer	vl:oe:r|vl:uː:r	72
vloeren	vl:oe::r:e:n|vl:uː::r:ə:	4
vloerkleed	vl:oe:r:kl:ee:d|vl:uː:r:kl:eː:t	3
vlogen	vl:o::g:e:n|vl:oː::ɣ:ə:	9
vloog	vl:oo:g|vl:oː:ç	29
vlot	vl:o:t|vl:ɔ:t	22
vlucht	vl:u:cht|vl:ʉ:çt	16
vluchten	vl:u:ch:t:e:n|vl:ʉ:ç:t:ə:	4
vlug	vl:u:g|vl:ʉ:ç	100
vocht	v:o:cht|v:ɔ:çt	5
voederbak	v:oe::d:e:r:b:a:k|v:uː::d:ə:r:b:ɑ:k	5
voeg	v:oe:g|v:uː:ç	5
voel	v:oe:l|v:uː:l	74
voelde	v:oe:l:d:e:|v:uː:l:d:ə:	8
voelen	v:oe::l:e:n|v:uː::l:ə:	14
voelt	v:oe:lt|v:uː:lt	163
voer	v:oe:r|v:uː:r	111
voeren	v:oe::r:e:n|v:uː::r:ə:	11
voert	v:oe:rt|v:uː:rt	17
voet	v:oe:t|v:uː:t	155
voetbal	v:oe:t:b:a:l|v:uː:d:b:ɑ:l	29
voetballen	v:oe:t:b:a:l:l:e:n|v:uː:d:b:ɑ::l:ə:	11
voetballer	v:oe:t:b:a:l:l:e:r|v:uː:d:b:ɑ::l:ə:r	2
voetbalschoen	v:oe:t:b:a:l:sch:oe:n|v:uː:d:b:ɑ:l:sç:uː:n	2
voetbalveld	v:oe:t:b:a:l:v:e:ld|v:uː:d:b:ɑ:l:v:ɛ:lt	3
voeten	v:oe::t:e:n|v:uː::t:ə:	45
voetje	v:oe:t:j:e:|v:uː:t:j:ə:	18
vogel	v:o::g:e:l|v:oː::ɣ:ə:l	57
vogelnest	v:o::g:e:l:n:e:st|v:oː::ɣ:ə:l:n:ɛ:st	3
vogels	v:o::g:e:ls|v:oː::ɣ:ə:ls	42
vogeltje	v:o::g:e:l:tj:e:|v:oː::ɣ:ə:l:tj:ə:	2
vol	v:o:l|v:ɔ:l	269
volg	v:o:lg|v:ɔ:lç	6
volgen	v:o:l:g:e:n|v:ɔ:l:ɣ:ə:	13
volgend	v:o:l:g:e:nd|v:ɔ:l:ɣ:ə:nt	3
volgende	v:o:l:g:e:n:d:e:|v:ɔ:l:ɣ:ə:n:d:ə:	69
volgens	v:o:l:g:e:ns|v:ɔ:l:ɣ:ə:ns	12
volgorde	v:o:lg::o:r:d:e:|v:ɔ:lɣ::ɔ:r:d:ə:	6
volgt	v:o:lgt|v:ɔ:lçt	23
volk	v:o:lk|v:ɔ:lk	13
volle	v:o:l:l:e:|v:ɔ::l:ə:	16
volop	v:o:l::o:p|v:ɔ:l::ɔ:p	2
vond	v:o:nd|v:ɔ:nt	83
vonden	v:o:n:d:e:n|v:ɔ:n:d:ə:	7
vonk	v:o:nk|v:ɔ:ŋk	8
voor	v:oo:r|v:oː:r	2329
vooraan	v:oo:r::aa:n|v:oː:r::aː:n	4
vooraf	v:oo:r::a:f|v:oː:r::ɑ:f	3
vooral	v:oo:r::a:l|v:oː:r::ɑ:l	34
voorbereid	v:oo:r:b:e::r:ei:d|v:oː:r:b:ə::r:ɛi:t	2
voorbij	v:oo:r:b:ij:|v:oː:r:b:ɛi:	72
voordat	v:oo:r:d:a:t|v:oː:r:d:ɑ:t	14
voordeur	v:oo:r:d:eu:r|v:oː:r:d:øː:r	29
voorgelezen	v:oo:r:g:e::l:e::z:e:n|v:oː:r:ɣ:ə::l:eː::z:ə:	4
voorgoed	v:oo:r:g:oe:d|v:oː:r:ɣ:uː:t	2
voorhoofd	v:oo:r:h:oo:fd|v:oː:r:h:oː:ft	17
voorin	v:oo:r::i:n|v:oː:r::ɪ:n	2
voorjaar	v:oo:r:j:aa:r|v:oː:r:j:aː:r	7
voorkant	v:oo:r:k:a:nt|v:oː:r:k:ɑ:nt	16
voorlaten	v:oo:r:l:a::t:e:n|v:oː:r:l:aː::t:ə:	3
voorleest	v:oo:r:l:ee:st|v:oː:r:l:eː:st	5
voorlezen	v:oo:r:l:e::z:e:n|v:oː:r:l:eː::z:ə:	15
voorlopig	v:oo:r:l:o::p:i:g|v:oː:r:l:oː::p:ə:ç	5
voorop	v:oo:r::o:p|v:oː:r::ɔ:p	14
voorover	v:oo:r::o::v:e:r|v:oː:r::oː::v:ə:r	4
voorpoten	v:oo:r:p:o::t:e:n|v:oː:r:p:oː::t:ə:	5
voorschijn	v:oo:r:sch:ij:n|v:oː:r:sç:ɛi:n	12
voorste	v:oo:r:st:e:|v:oː:r:st:ə:	4
voorstellen	v:oo:r:st:e:l:l:e:n|v:oː:r:st:ɛ::l:ə:	2
voorstelling	v:oo:r:st:e:l:l:i:ng|v:oː:r:st:ɛ::l:ɪ:ŋ	27
voort	v:oo:rt|v:oː:rt	5
voortaan	v:oo:r:t:aa:n|v:oː:r:t:aː:n	9
vooruit	v:oo:r::ui:t|v:oː:r::œy:t	25
voorzeggen	v:oo:r:z:e:g:g:e:n|v:oː:r:z:ɛ::ɣ:ə:	4
voorzichtig	v:oo:r:z:i:ch:t:i:g|v:oː:r:z:ɪ:ç:t:ə:ç	35
voos	v:oo:s|v:oː:s	7
voren	v:o::r:e:n|v:oː::r:ə:	32
vorig	v:o::r:i:g|v:oː::r:ə:ç	4
vorige	v:o::r:i::g:e:|v:oː::r:ə::ɣ:ə:	8
vork	v:o:rk|v:ɔ:rk	16
vorken	v:o:r:k:e:n|v:ɔ:r:k:ə:	5
vorm	v:o:rm|v:ɔ:rm	18
vormpjes	v:o:rm:pj:e:s|v:ɔ:rm:pj:ə:s	6
vorst	v:o:rst|v:ɔ:rst	25
vos	v:o:s|v:ɔ:s	264
vosje	v:o:s:j:e:|v:ɔ:s:j:ə:	24
vossen	v:o:s:s:e:n|v:ɔ::s:ə:	3
vouw	v:ou:w|v:ɑu:w	5
vouwen	v:ou::w:e:n|v:ɑu::w:ə:	3
vouwt	v:ou:wt|v:ɑu:wt	9
vraag	vr:aa:g|vr:aː:ç	84
vraagt	vr:aa:gt|vr:aː:çt	969
vracht	vr:a:cht|vr:ɑ:çt	5
vrachtschip	vr:a:cht:sch:i:p|vr:ɑ:çt:sç:ɪ:p	2
vragen	vr:a::g:e:n|vr:aː::ɣ:ə:	51
vragend	vr:a::g:e:nd|vr:aː::ɣ:ə:nt	2
vrat	vr:a:t|vr:ɑ:t	3
vreemd	vr:ee:md|vr:eː:mt	28
vreemde	vr:ee:m:d:e:|vr:eː:m:d:ə:	12
vreselijk	vr:e::s:e::l:ij:k|vr:eː::s:ə::l:ə:k	13
vreugde	vr:eu:g:d:e:|vr:øː:ɣ:d:ə:	3
vriend	vr:ie:nd|vr:iː:nt	110
vriendelijk	vr:ie:n:d:e::l:ij:k|vr:iː:n:d:ə::l:ə:k	5
vrienden	vr:ie:n:d:e:n|vr:iː:n:d:ə:	53
vriendin	vr:ie:n:d:i:n|vr:iː:n:d:ɪ:n	43
vriendje	vr:ie:nd:j:e:|vr:iː:nt:j:ə:	18
vriendjes	vr:ie:nd:j:e:s|vr:iː:nt:j:ə:s	12
vries	vr:ie:s|vr:iː:s	6
vriest	vr:ie:st|vr:iː:st	3
vriezen	vr:ie::z:e:n|vr:iː::z:ə:	4
vriezer	vr:ie::z:e:r|vr:iː::z:ə:r	3
vrij	vr:ij:|vr:ɛi:	50
vrijdag	vr:ij::d:a:g|vr:ɛi::d:ɑ:ç	15
vrije	vr:ij:::e:|vr:ɛi::j:ə:	5
vrijlaten	vr:ij::l:a::t:e:n|vr:ɛi::l:aː::t:ə:	3
vroeg	vr:oe:g|vr:uː:ç	135
vroeger	vr:oe::g:e:r|vr:uː::ɣ:ə:r	66
vrolijk	vr:o::l:ij:k|vr:oː::l:ə:k	66
vrolijke	vr:o::l:ij::k:e:|vr:oː::l:ə::k:ə:	8
vroor	vr:oo:r|vr:oː:r	2
vrouw	vr:ou:w|vr:ɑu:w	202
vrouwen	vr:ou::w:e:n|vr:ɑu::w:ə:	11
vrouwtje	vr:ou:w:tj:e:|vr:ɑu:w:tj:ə:	9
vrouwtjes	vr:ou:w:tj:e:s|vr:ɑu:w:tj:ə:s	7
vrucht	vr:u:cht|vr:ʉ:çt	2
vruchten	vr:u:ch:t:e:n|vr:ʉ:ç:t:ə:	5
vuil	v:ui:l|v:œy:l	23
vuilnisbak	v:ui:l:n:i:s:b:a:k|v:œy:l:n:ɪ:z:b:ɑ:k	10
vuist	v:ui:st|v:œy:st	6
vul	v:u:l|v:ʉ:l	35
vulden	v:u:l:d:e:n|v:ʉ:l:d:ə:	2
vulpen	v:u:l:p:e:n|v:ʉ:l:p:ɛ:n	6
vult	v:u:lt|v:ʉ:lt	17
vuren	v:u::r:e:n|v:yː::r:ə:	3
vuur	v:uu:r|v:yː:r	148
vuurrood	v:uu:r:r:oo:d|v:yː::r:oː:t	4
vuurtje	v:uu:r:tj:e:|v:yː:r:tj:ə:	7
vuurwerk	v:uu:r:w:e:rk|v:yː:r:w:ɛ:rk	14
w	w::|w:eː:	158
waai	w:aa:i|w:aː:j	2
waaide	w:aa:i:d:e:|w:aː:j:d:ə:	3
waaien	w:aa:i::e:n|w:aː::j:ə:	7
waait	w:aa:it|w:aː:jt	31
waak	w:aa:k|w:aː:k	2
waar	w:aa:r|w:aː:r	980
waard	w:aa:rd|w:aː:rt	9
waarin	w:aa:r::i:n|w:aː:r::ɪ:n	4
waarmee	w:aa:r:m:ee:|w:aː:r:m:eː:	8
waarom	w:aa:r::o:m|w:aː:r::ɔ:m	180
waarop	w:aa:r::o:p|w:aː:r::ɔ:p	9
waarover	w:aa:r::o::v:e:r|w:aː:r::oː::v:ə:r	3
waarschuw	w:aa:r:sch:u:w|w:aː:r:sç:yː:w	4
waarschuwing	w:aa:r:sch:u::w:i:ng|w:aː:r:sç:yː::w:ɪ:ŋ	3
waarschuwt	w:aa:r:sch:u:wt|w:aː:r:sç:yː:wt	4
waarvan	w:aa:r:v:a:n|w:aː:r:v:ɑ:n	5
waarvoor	w:aa:r:v:oo:r|w:aː:r:v:oː:r	3
wacht	w:a:cht|w:ɑ:çt	178
wachten	w:a:ch:t:e:n|w:ɑ:ç:t:ə:	72
wachtten	w:a:cht:t:e:n|w:ɑ:ç:t:ə:	2
waddenzee	w:a:d:d:e:n:z:ee:|w:ɑ::d:ə::z:eː:	2
waf	w:a:f|w:ɑ:f	10
wafel	w:a::f:e:l|w:aː::f:ə:l	7
wagen	w:a::g:e:n|w:aː::ɣ:ə:	23
wak	w:a:k|w:ɑ:k	6
waken	w:a::k:e:n|w:aː::k:ə:	3
wakker	w:a:k:k:e:r|w:ɑ::k:ə:r	81
wal	w:a:l|w:ɑ:l	10
wals	w:a:ls|w:ɑ:ls	2
walvis	w:a:l:v:i:s|w:ɑ:l:v:ɪ:s	7
wan	w:a:n|w:ɑ:n	2
wand	w:a:nd|w:ɑ:nt	5
wandel	w:a:n:d:e:l|w:ɑ:n:d:ə:l	2
wandelen	w:a:n:d:e::l:e:n|w:ɑ:n:d:ə::l:ə:	9
wandeling	w:a:n:d:e::l:i:ng|w:ɑ:n:d:ə::l:ɪ:ŋ	3
wandelt	w:a:n:d:e:lt|w:ɑ:n:d:ə:lt	5
wang	w:a:ng|w:ɑ:ŋ	50
wangen	w:a:n:g:e:n|w:ɑ::ŋ:ə:	27
wanhopig	w:a:n:h:o::p:i:g|w:ɑ:n:h:oː::p:ə:ç	2
wanneer	w:a:n:n:ee:r|w:ɑ::n:eː:r	30
want	w:a:nt|w:ɑ:nt	329
wanten	w:a:n:t:e:n|w:ɑ:n:t:ə:	16
wapen	w:a::p:e:n|w:aː::p:ə:	3
wapens	w:a::p:e:ns|w:aː::p:ə:ns	4
wapperen	w:a:p:p:e::r:e:n|w:ɑ::p:ə::r:ə:	2
wappert	w:a:p:p:e:rt|w:ɑ::p:ə:rt	4
war	w:a:r|w:ɑ:r	20
waren	w:a::r:e:n|w:aː::r:ə:	86
warm	w:a:rm|w:ɑ:rm	147
warme	w:a:r:m:e:|w:ɑ:r:m:ə:	41
warmt	w:a:rmt|w:ɑ:rmt	2
warmte	w:a:rm:t:e:|w:ɑ:rm:t:ə:	3
was	w:a:s|w:ɑ:s	1153
wasbak	w:a:s:b:a:k|w:ɑ:z:b:ɑ:k	2
washandje	w:a:s:h:a:nd:j:e:|w:ɑ:s:h:ɑ:nt:j:ə:	2
waslijn	w:a:s:l:ij:n|w:ɑ:s:l:ɛi:n	6
wasmand	w:a:s:m:a:nd|w:ɑ:s:m:ɑ:nt	8
wassen	w:a:s:s:e:n|w:ɑ::s:ə:	18
wast	w:a:st|w:ɑ:st	25
wastobbe	w:a:s:t:o:b:b:e:|w:ɑ:s:t:ɔ::b:ə:	2
wat	w:a:t|w:ɑ:t	3757
water	w:a::t:e:r|w:aː::t:ə:r	207
waterpomp	w:a::t:e:r:p:o:mp|w:aː::t:ə:r:p:ɔ:mp	2
watten	w:a:t:t:e:n|w:ɑ::t:ə:	3
wauw	w:au:w|w:ɑu:w	24
wazig	w:a::z:i:g|w:aː::z:ə:ç	2
we	w:e:|w:ə:	1414
web	w:e:b|w:ɛ:p	36
wed	w:e:d|w:ɛ:t	3
wedden	w:e:d:d:e:n|w:ɛ::d:ə:	3
wedstrijd	w:e:d:str:ij:d|w:ɛ:t:str:ɛi:t	23
wedstrijden	w:e:d:str:ij::d:e:n|w:ɛ:t:str:ɛi::d:ə:	4
weeg	w:ee:g|w:eː:ç	11
weegt	w:ee:gt|w:eː:çt	16
week	w:ee:k|w:eː:k	83
weekeinde	w:ee:k::ei:n:d:e:|w:eː:k::ɛi:n:d:ə:	2
weekend	w:ee:k::e:nd|w:iː::k:ɛ:nt	4
weekje	w:ee:k:j:e:|w:eː:k:j:ə:	6
weer	w:ee:r|w:eː:r	1460
wees	w:ee:s|w:eː:s	49
weet	w:ee:t|w:eː:t	1260
weg	w:e:g|w:ɛ:ç	1451
wegblijven	w:e:g:bl:ij::v:e:n|w:ɛ:ɣ:bl:ɛi::v:ə:	2
wegduwen	w:e:g:d:u::w:e:n|w:ɛ:ɣ:d:yː::w:ə:	4
wegen	w:e::g:e:n|w:eː::ɣ:ə:	4
weggaan	w:e:g:g:aa:n|w:ɛ::ɣ:aː:n	3
weggedoken	w:e:g:g:e::d:o::k:e:n|w:ɛ::ɣ:ə::d:oː::k:ə:	2
wegkomt	w:e:g:k:o:mt|w:ɛ:ç:k:ɔ:mt	2
weglopen	w:e:g:l:o::p:e:n|w:ɛ:ɣ:l:oː::p:ə:	2
wegrennen	w:e:g:r:e:n:n:e:n|w:ɛ:ɣ:r:ɛ::n:ə:	4
wegrent	w:e:g:r:e:nt|w:ɛ:ɣ:r:ɛ:nt	2
wegstopt	w:e:g:st:o:pt|w:ɛ:ç:st:ɔ:pt	2
wegwezen	w:e:g:w:e::z:e:n|w:ɛ:ɣ:w:eː::z:ə:	5
wei	w:ei:|w:ɛi:	44
weiden	w:ei::d:e:n|w:ɛi::d:ə:	2
weiland	w:ei::l:a:nd|w:ɛi::l:ɑ:nt	11
weilanden	w:ei::l:a:n:d:e:n|w:ɛi::l:ɑ:n:d:ə:	3
weinig	w:ei::n:i:g|w:ɛi::n:ə:ç	14
weitje	w:ei::tj:e:|w:ɛi::tj:ə:	2
wek	w:e:k|w:ɛ:k	4
weken	w:e::k:e:n|w:eː::k:ə:	21
wekker	w:e:k:k:e:r|w:ɛ::k:ə:r	12
wel	w:e:l|w:ɛ:l	1700
welk	w:e:lk|w:ɛ:lk	77
welke	w:e:l:k:e:|w:ɛ:l:k:ə:	59
welkom	w:e:l:k:o:m|w:ɛ:l:k:ɔ:m	19
welnee	w:e:l:n:ee:|w:ɛ:l:n:eː:	6
welp	w:e:lp|w:ɛ:lp	6
wen	w:e:n|w:ɛ:n	6
wenk	w:e:nk|w:ɛ:ŋk	9
wenkt	w:e:nkt|w:ɛ:ŋkt	12
wennen	w:e:n:n:e:n|w:ɛ::n:ə:	4
wens	w:e:ns|w:ɛ:ns	64
wensen	w:e:n:s:e:n|w:ɛ:n:s:ə:	23
wenst	w:e:nst|w:ɛ:nst	4
went	w:e:nt|w:ɛ:nt	4
werd	w:e:rd|w:ɛ:rt	81
werden	w:e:r:d:e:n|w:ɛ:r:d:ə:	9
wereld	w:e::r:e:ld|w:eː::r:ə:lt	98
werk	w:e:rk|w:ɛ:rk	137
werkblad	w:e:rk:bl:a:d|w:ɛ:rɡ:bl:ɑ:t	588
werkboekje	w:e:rk:b:oe:k:j:e:|w:ɛ:rɡ:b:uː:k:j:ə:	6
werken	w:e:r:k:e:n|w:ɛ:r:k:ə:	50
werkje	w:e:rk:j:e:|w:ɛ:rk:j:ə:	3
werkkamer	w:e:rk:k:a::m:e:r|w:ɛ:r:k:aː::m:ə:r	2
werksters	w:e:rk:st:e:rs|w:ɛ:rk:st:ə:rs	5
werkt	w:e:rkt|w:ɛ:rkt	68
werkten	w:e:rk:t:e:n|w:ɛ:rk:t:ə:	3
werpt	w:e:rpt|w:ɛ:rpt	3
wesp	w:e:sp|w:ɛ:sp	15
wespen	w:e:s:p:e:n|w:ɛ:s:p:ə:	3
west	w:e:st|w:ɛ:st	2
wet	w:e:t|w:ɛ:t	5
weten	w:e::t:e:n|w:eː::t:ə:	94
weven	w:e::v:e:n|w:eː::v:ə:	5
wezen	w:e::z:e:n|w:eː::z:ə:	2
wie	w:ie:|w:iː:	522
wiebelen	w:ie::b:e::l:e:n|w:iː::b:ə::l:ə:	2
wiebelt	w:ie::b:e:lt|w:iː::b:ə:lt	11
wieg	w:ie:g|w:iː:ç	13
wiegt	w:ie:gt|w:iː:çt	4
wiel	w:ie:l|w:iː:l	29
wielen	w:ie::l:e:n|w:iː::l:ə:	7
wies	w:ie:s|w:iː:s	124
wij	w:ij:|w:ɛi:	227
wijd	w:ij:d|w:ɛi:t	15
wijde	w:ij::d:e:|w:ɛi::d:ə:	22
wijk	w:ij:k|w:ɛi:k	5
wijn	w:ij:n|w:ɛi:n	43
wijs	w:ij:s|w:ɛi:s	28
wijsje	w:ij:s:j:e:|w:ɛi:s:j:ə:	7
wijsjes	w:ij:s:j:e:s|w:ɛi:s:j:ə:s	2
wijsneus	w:ij:s:n:eu:s|w:ɛi:s:n:øː:s	5
wijst	w:ij:st|w:ɛi:st	195
wijze	w:ij::z:e:|w:ɛi::z:ə:	2
wijzen	w:ij::z:e:n|w:ɛi::z:ə:	7
wijzer	w:ij::z:e:r|w:ɛi::z:ə:r	2
wijzers	w:ij::z:e:rs|w:ɛi::z:ə:rs	2
wikkelt	w:i:k:k:e:lt|w:ɪ::k:ə:lt	2
wil	w:i:l|w:ɪ:l	1876
wild	w:i:ld|w:ɪ:lt	48
wilde	w:i:l:d:e:|w:ɪ:l:d:ə:	78
wilden	w:i:l:d:e:n|w:ɪ:l:d:ə:	14
wille	w:i:l:l:e:|w:ɪ::l:ə:	4
willen	w:i:l:l:e:n|w:ɪ::l:ə:	94
wilt	w:i:lt|w:ɪ:lt	80
wimpers	w:i:m:p:e:rs|w:ɪ:m:p:ə:rs	4
win	w:i:n|w:ɪ:n	17
wind	w:i:nd|w:ɪ:nt	97
windje	w:i:nd:j:e:|w:ɪ:nt:j:ə:	2
windvlaag	w:i:nd:vl:aa:g|w:ɪ:nt:fl:aː:ç	6
winkel	w:i:n:k:e:l|w:ɪ:ŋ:k:ə:l	67
winkelen	w:i:n:k:e::l:e:n|w:ɪ:ŋ:k:ə::l:ə:	3
winkels	w:i:n:k:e:ls|w:ɪ:ŋ:k:ə:ls	16
winnaar	w:i:n:n:aa:r|w:ɪ::n:aː:r	23
winnen	w:i:n:n:e:n|w:ɪ::n:ə:	19
wint	w:i:nt|w:ɪ:nt	28
winter	w:i:n:t:e:r|w:ɪ:n:t:ə:r	35
winterjas	w:i:n:t:e:r:j:a:s|w:ɪ:n:t:ə:r:j:ɑ:s	9
wip	w:i:p|w:ɪ:p	51
wippen	w:i:p:p:e:n|w:ɪ::p:ə:	3
wipt	w:i:pt|w:ɪ:pt	20
wist	w:i:st|w:ɪ:st	87
wisten	w:i:s:t:e:n|w:ɪ:s:t:ə:	7
wit	w:i:t|w:ɪ:t	213
witje	w:i:t:j:e:|w:ɪ:t:j:ə:	5
witte	w:i:t:t:e:|w:ɪ::t:ə:	62
woede	w:oe::d:e:|w:uː::d:ə:	3
woedend	w:oe::d:e:nd|w:uː::d:ə:nt	5
woef	w:oe:f|w:uː:f	56
woelt	w:oe:lt|w:uː:lt	2
woensdag	w:oe:ns:d:a:g|w:uː:nz:d:ɑ:ç	15
woest	w:oe:st|w:uː:st	25
woeste	w:oe:s:t:e:|w:uː:s:t:ə:	8
woestijn	w:oe:s:t:ij:n|w:uː:s:t:ɛi:n	6
wol	w:o:l|w:ɔ:l	26
wolf	w:o:lf|w:ɔ:lf	141
wolk	w:o:lk|w:ɔ:lk	55
wolken	w:o:l:k:e:n|w:ɔ:l:k:ə:	38
wollen	w:o:l:l:e:n|w:ɔ::l:ə:	2
wolven	w:o:l:v:e:n|w:ɔ:l:v:ə:	3
won	w:o:n|w:ɔ:n	6
wond	w:o:nd|w:ɔ:nt	14
wonder	w:o:n:d:e:r|w:ɔ:n:d:ə:r	6
wonen	w:o::n:e:n|w:oː::n:ə:	75
woning	w:o::n:i:ng|w:oː::n:ɪ:ŋ	5
woon	w:oo:n|w:oː:n	94
woonde	w:oo:n:d:e:|w:oː:n:d:ə:	15
woont	w:oo:nt|w:oː:nt	262
woord	w:oo:rd|w:oː:rt	157
woorden	w:oo:r:d:e:n|w:oː:r:d:ə:	78
woordjes	w:oo:rd:j:e:s|w:oː:rt:j:ə:s	12
word	w:o:rd|w:ɔ:rt	89
worden	w:o:r:d:e:n|w:ɔ:r:d:ə:	164
wordt	w:o:rdt|w:ɔ:rt	433
worm	w:o:rm|w:ɔ:rm	88
wormen	w:o:r:m:e:n|w:ɔ:r:m:ə:	6
worst	w:o:rst|w:ɔ:rst	42
wortel	w:o:r:t:e:l|w:ɔ:r:t:ə:l	11
wortels	w:o:r:t:e:ls|w:ɔ:r:t:ə:ls	6
worteltje	w:o:r:t:e:l:tj:e:|w:ɔ:r:t:ə:l:tj:ə:	2
worteltjes	w:o:r:t:e:l:tj:e:s|w:ɔ:r:t:ə:l:tj:ə:s	4
wou	w:ou:|w:ɑu:w	53
woud	w:ou:d|w:ɑu:t	10
wouter	w:ou::t:e:r|w:ɑu::t:ə:r	5
wow	w:o:w|w:ɑu:	3
wraak	wr:aa:k|wr:aː:k	2
wrak	wr:a:k|wr:ɑ:k	3
wrat	wr:a:t|wr:ɑ:t	2
wreed	wr:ee:d|wr:eː:t	3
wrijft	wr:ij:ft|wr:ɛi:ft	15
wrijven	wr:ij::v:e:n|wr:ɛi::v:ə:	2
wuif	w:ui:f|w:œy:f	2
wuift	w:ui:ft|w:œy:ft	24
wurmen	w:u:r:m:e:n|w:ʉ:r:m:ə:	2
yes	:y:es|j:ɛ:s	2
z	z::|z:ɛ:t	441
zaad	z:aa:d|z:aː:t	9
zaadje	z:aa:d:j:e:|z:aː:t:j:ə:	2
zaadjes	z:aa:d:j:e:s|z:aː:t:j:ə:s	6
zaag	z:aa:g|z:aː:ç	50
zaagsel	z:aa:g:s:e:l|z:aː:ç:s:ə:l	3
zaagt	z:aa:gt|z:aː:çt	15
zaai	z:aa:i|z:aː:j	4
zaait	z:aa:it|z:aː:jt	2
zaak	z:aa:k|z:aː:k	22
zaal	z:aa:l|z:aː:l	54
zacht	z:a:cht|z:ɑ:çt	162
zachte	z:a:ch:t:e:|z:ɑ:ç:t:ə:	18
zachtjes	z:a:cht:j:e:s|z:ɑ:ç:j:ə:s	37
zachts	z:a:chts|z:ɑ:çts	2
zag	z:a:g|z:ɑ:ç	138
zagen	z:a::g:e:n|z:aː::ɣ:ə:	25
zak	z:a:k|z:ɑ:k	197
zakdoek	z:a:k:d:oe:k|z:ɑ:ɡ:d:uː:k	34
zaken	z:a::k:e:n|z:aː::k:ə:	2
zakje	z:a:k:j:e:|z:ɑ:k:j:ə:	26
zakjes	z:a:k:j:e:s|z:ɑ:k:j:ə:s	4
zakken	z:a:k:k:e:n|z:ɑ::k:ə:	39
zaklamp	z:a:k:l:a:mp|z:ɑ:k:l:ɑ:mp	27
zakmes	z:a:k:m:e:s|z:ɑ:k:m:ɛ:s	8
zakt	z:a:kt|z:ɑ:kt	34
zal	z:a:l|z:ɑ:l	243
zalen	z:a::l:e:n|z:aː::l:ə:	3
zalf	z:a:lf|z:ɑ:lf	6
zalm	z:a:lm|z:ɑ:lm	4
zand	z:a:nd|z:ɑ:nt	65
zandbak	z:a:nd:b:a:k|z:ɑ:nd:b:ɑ:k	22
zanden	z:a:n:d:e:n|z:ɑ:n:d:ə:	5
zandkasteel	z:a:nd:k:a:s:t:ee:l|z:ɑ:nt:k:ɑ:s:t:eː:l	4
zang	z:a:ng|z:ɑ:ŋ	5
zanger	z:a:n:g:e:r|z:ɑ::ŋ:ə:r	2
zat	z:a:t|z:ɑ:t	129
zaten	z:a::t:e:n|z:aː::t:ə:	17
zaterdag	z:a::t:e:r:d:a:g|z:aː::t:ə:r:d:ɑ:ç	18
ze	z:e:|z:ə:	7093
zebra	z:e::br:a:|z:eː::br:aː:	7
zebrapad	z:e::br:a::p:a:d|z:eː::br:aː::p:ɑ:t	4
zee	z:ee:|z:eː:	536
zeef	z:ee:f|z:eː:f	11
zeehond	z:ee::h:o:nd|z:eː::h:ɔ:nt	32
zeekaart	z:ee::k:aa:rt|z:eː::k:aː:rt	2
zeeland	z:ee::l:a:nd|z:eː::l:ɑ:nt	3
zeelieden	z:ee::l:ie::d:e:n|z:eː::l:iː::d:ə:	2
zeelui	z:ee::l:ui:|z:eː::l:œy:	5
zeem	z:ee:m|z:eː:m	3
zeeman	z:ee::m:a:n|z:eː::m:ɑ:n	52
zeemeermin	z:ee::m:ee:r:m:i:n|z:eː::m:eː:r:m:ɪ:n	6
zeemt	z:ee:mt|z:eː:mt	3
zeep	z:ee:p|z:eː:p	111
zeepaard	z:ee::p:aa:rd|z:eː::p:aː:rt	2
zeepbel	z:ee:p:b:e:l|z:eː::b:ɛ:l	2
zeepjes	z:ee:p:j:e:s|z:eː:p:j:ə:s	2
zeer	z:ee:r|z:eː:r	51
zeerover	z:ee::r:o::v:e:r|z:eː::r:oː::v:ə:r	2
zeerovers	z:ee::r:o::v:e:rs|z:eː::r:oː::v:ə:rs	10
zeester	z:ee::st:e:r|z:eː::st:ɛ:r	18
zeewier	z:ee::w:ie:r|z:eː::w:iː:r	6
zeg	z:e:g|z:ɛ:ç	232
zegel	z:e::g:e:l|z:eː::ɣ:ə:l	4
zeggen	z:e:g:g:e:n|z:ɛ::ɣ:ə:	140
zegt	z:e:gt|z:ɛ:çt	5494
zei	z:ei:|z:ɛi:	382
zeiden	z:ei::d:e:n|z:ɛi::d:ə:	6
zeil	z:ei:l|z:ɛi:l	43
zeilboot	z:ei:l:b:oo:t|z:ɛi:l:b:oː:t	5
zeilen	z:ei::l:e:n|z:ɛi::l:ə:	13
zeilschip	z:ei:l:sch:i:p|z:ɛi:l:sç:ɪ:p	4
zeis	z:ei:s|z:ɛi:s	4
zeker	z:e::k:e:r|z:eː::k:ə:r	108
zekerheid	z:e::k:e:r:h:ei:d|z:eː::k:ə:r:h:ɛi:t	3
zelf	z:e:lf|z:ɛ:lf	229
zelfs	z:e:lfs|z:ɛ:lfs	85
zemen	z:e::m:e:n|z:eː::m:ə:	3
zend	z:e:nd|z:ɛ:nt	2
zenuwachtig	z:e::n:u:w::a:ch:t:i:g|z:eː::n:yː:w::ɑ:ç:t:ə:ç	4
zeppelin	z:e:p:p:e::l:i:n|z:ɛ::p:ə::l:ɪ:n	7
zere	z:e::r:e:|z:eː::r:ə:	2
zes	z:e:s|z:ɛ:s	168
zesde	z:e:s:d:e:|z:ɛ:z:d:ə:	2
zestien	z:e:s:t:ie:n|z:ɛ:s:t:iː:n	5
zet	z:e:t|z:ɛ:t	439
zetje	z:e:t:j:e:|z:ɛ:t:j:ə:	2
zette	z:e:t:t:e:|z:ɛ::t:ə:	9
zetten	z:e:t:t:e:n|z:ɛ::t:ə:	43
zeult	z:eu:lt|z:øː:lt	2
zeur	z:eu:r|z:øː:r	14
zeuren	z:eu::r:e:n|z:øː::r:ə:	6
zeurt	z:eu:rt|z:øː:rt	19
zeven	z:e::v:e:n|z:eː::v:ə:	54
zich	z:i:ch|z:ɪ:ç	495
zicht	z:i:cht|z:ɪ:çt	5
zichzelf	z:i:ch:z:e:lf|z:ɪ:ɣ:z:ɛ:lf	38
zie	z:ie:|z:iː:	528
ziek	z:ie:k|z:iː:k	105
zieke	z:ie::k:e:|z:iː::k:ə:	2
ziekenauto	z:ie::k:e:n::au::t:o:|z:iː::k:ə:::ɑu::t:oː:	4
ziekenhuis	z:ie::k:e:n:h:ui:s|z:iː::k:ə::h:œy:s	22
zielig	z:ie::l:i:g|z:iː::l:ə:ç	32
zielige	z:ie::l:i::g:e:|z:iː::l:ə::ɣ:ə:	3
zien	z:ie:n|z:iː:n	638
ziet	z:ie:t|z:iː:t	872
ziezo	z:ie::z:o:|z:iː::z:oː:	18
zigzag	z:i:g:z:a:g|z:ɪ:ç:s:ɑ:ç	3
zij	z:ij:|z:ɛi:	263
zijkant	z:ij::k:a:nt|z:ɛi::k:ɑ:nt	3
zijn	z:ij:n|z:ɛi:n	4189
zilver	z:i:l:v:e:r|z:ɪ:l:v:ə:r	9
zin	z:i:n|z:ɪ:n	206
zing	z:i:ng|z:ɪ:ŋ	57
zingen	z:i:n:g:e:n|z:ɪ::ŋ:ə:	63
zingend	z:i:n:g:e:nd|z:ɪ::ŋ:ə:nt	5
zingt	z:i:ngt|z:ɪ:ŋt	99
zink	z:i:nk|z:ɪ:ŋk	12
zinken	z:i:n:k:e:n|z:ɪ:ŋ:k:ə:	7
zinkt	z:i:nkt|z:ɪ:ŋkt	3
zinnen	z:i:n:n:e:n|z:ɪ::n:ə:	16
zit	z:i:t|z:ɪ:t	1415
zitten	z:i:t:t:e:n|z:ɪ::t:ə:	374
zo	z:o:|z:oː:	1508
zoals	z:o:::a:ls|z:oː::w:ɑ:ls	39
zocht	z:o:cht|z:ɔ:çt	16
zochten	z:o:ch:t:e:n|z:ɔ:ç:t:ə:	3
zodat	z:o::d:a:t|z:oː::d:ɑ:t	13
zodra	z:o::dr:a:|z:oː::dr:aː:	6
zoef	z:oe:f|z:uː:f	9
zoeft	z:oe:ft|z:uː:ft	6
zoek	z:oe:k|z:uː:k	417
zoeken	z:oe::k:e:n|z:uː::k:ə:	127
zoekt	z:oe:kt|z:uː:kt	217
zoem	z:oe:m|z:uː:m	77
zoemen	z:oe::m:e:n|z:uː::m:ə:	3
zoemt	z:oe:mt|z:uː:mt	17
zoen	z:oe:n|z:uː:n	82
zoenen	z:oe::n:e:n|z:uː::n:ə:	7
zoent	z:oe:nt|z:uː:nt	2
zoet	z:oe:t|z:uː:t	72
zoete	z:oe::t:e:|z:uː::t:ə:	4
zogenaamd	z:o::g:e::n:aa:md|z:oː::ɣ:ə::n:aː:mt	3
zolang	z:o::l:a:ng|z:oː::l:ɑ:ŋ	12
zolder	z:o:l:d:e:r|z:ɔ:l:d:ə:r	27
zolen	z:o::l:e:n|z:oː::l:ə:	2
zomaar	z:o::m:aa:r|z:oː::m:aː:r	51
zomer	z:o::m:e:r|z:oː::m:ə:r	44
zon	z:o:n|z:ɔ:n	323
zondag	z:o:n:d:a:g|z:ɔ:n:d:ɑ:ç	36
zonde	z:o:n:d:e:|z:ɔ:n:d:ə:	2
zonder	z:o:n:d:e:r|z:ɔ:n:d:ə:r	129
zonen	z:o::n:e:n|z:oː::n:ə:	3
zonen	z:o::n:e:n|z:ɒː::n:ə:	3
zong	z:o:ng|z:ɔ:ŋ	9
zonk	z:o:nk|z:ɔ:ŋk	4
zonnebril	z:o:n:n:e::br:i:l|z:ɔ::n:ə::br:ɪ:l	4
zonnen	z:o:n:n:e:n|z:ɔ::n:ə:	2
zonnetje	z:o:n:n:e::tj:e:|z:ɔ::n:ə::tj:ə:	3
zonnetjes	z:o:n:n:e::tj:e:s|z:ɔ::n:ə::tj:ə:s	37
zoog	z:oo:g|z:oː:ç	3
zool	z:oo:l|z:oː:l	4
zoon	z:oo:n|z:oː:n	41
zoontje	z:oo:n:tj:e:|z:oː:n:tj:ə:	3
zorg	z:o:rg|z:ɔ:rç	40
zorgde	z:o:rg:d:e:|z:ɔ:rɣ:d:ə:	3
zorgen	z:o:r:g:e:n|z:ɔ:r:ɣ:ə:	30
zorgt	z:o:rgt|z:ɔ:rçt	33
zou	z:ou:|z:ɑu:w	271
zouden	z:ou::d:e:n|z:ɑu::d:ə:	9
zout	z:ou:t|z:ɑu:t	86
zoute	z:ou::t:e:|z:ɑu::t:ə:	2
zoveel	z:o::v:ee:l|z:oː::v:eː:l	48
zover	z:o::v:e:r|z:oː::v:ɛ:r	13
zowat	z:o::w:a:t|z:oː::w:ɑ:t	2
zozo	z:o::z:o:|z:oː::z:oː:	2
zucht	z:u:cht|z:ʉ:çt	198
zuchten	z:u:ch:t:e:n|z:ʉ:ç:t:ə:	4
zuchtend	z:u:ch:t:e:nd|z:ʉ:ç:t:ə:nt	8
zuchtten	z:u:cht:t:e:n|z:ʉ:ç:t:ə:	2
zuid	z:ui:d|z:œy:t	4
zuidpool	z:ui:d:p:oo:l|z:œy:t:p:oː:l	3
zuig	z:ui:g|z:œy:ç	4
zuigt	z:ui:gt|z:œy:çt	12
zuinig	z:ui::n:i:g|z:œy::n:ə:ç	5
zul	z:u:l|z:ʉ:lt	14
zullen	z:u:l:l:e:n|z:ʉ::l:ə:	80
zult	z:u:lt|z:ʉ:lt	14
zure	z:u::r:e:|z:yː::r:ə:	2
zus	z:u:s|z:ʉ:s	102
zusje	z:u:s:j:e:|z:ʉ:s:j:ə:	51
zusjes	z:u:s:j:e:s|z:ʉ:s:j:ə:s	12
zuur	z:uu:r|z:yː:r	26
zuurkool	z:uu:r:k:oo:l|z:yː:r:k:oː:l	4
zuurtje	z:uu:r:tj:e:|z:yː:r:tj:ə:	2
zwaai	zw:aa:i|zw:aː:j	16
zwaaide	zw:aa:i:d:e:|zw:aː:j:d:ə:	9
zwaaiden	zw:aa:i:d:e:n|zw:aː:j:d:ə:	4
zwaaien	zw:aa:i::e:n|zw:aː::j:ə:	28
zwaait	zw:aa:it|zw:aː:jt	85
zwaan	zw:aa:n|zw:aː:n	59
zwaar	zw:aa:r|zw:aː:r	50
zwaard	zw:aa:rd|zw:aː:rt	51
zwaarden	zw:aa:r:d:e:n|zw:aː:r:d:ə:	2
zwaarder	zw:aa:r:d:e:r|zw:aː:r:d:ə:r	2
zwak	zw:a:k|zw:ɑ:k	5
zwakke	zw:a:k:k:e:|zw:ɑ::k:ə:	2
zwaluw	zw:a::l:u:w|zw:aː::l:yː:w	5
zwanen	zw:a::n:e:n|zw:aː::n:ə:	5
zware	zw:a::r:e:|zw:aː::r:ə:	13
zwart	zw:a:rt|zw:ɑ:rt	92
zwarte	zw:a:r:t:e:|zw:ɑ:r:t:ə:	61
zwavel	zw:a::v:e:l|zw:aː::v:ə:l	2
zweefde	zw:ee:f:d:e:|zw:eː:v:d:ə:	4
zweeft	zw:ee:ft|zw:eː:ft	29
zweefvliegtuig	zw:ee:f:vl:ie:g:t:ui:g|zw:eː::fl:iː:ç:t:œy:ç	3
zweep	zw:ee:p|zw:eː:p	11
zweer	zw:ee:r|zw:eː:r	2
zweet	zw:ee:t|zw:eː:t	17
zwem	zw:e:m|zw:ɛ:m	26
zwembad	zw:e:m:b:a:d|zw:ɛ:m:b:ɑ:t	43
zwembroek	zw:e:m:br:oe:k|zw:ɛ:m:br:uː:k	26
zwemdiploma	zw:e:m:d:i::pl:o::m:a:|zw:ɛ:m:d:iː::pl:oː::m:aː:	2
zwemles	zw:e:m:l:e:s|zw:ɛ:m:l:ɛ:s	19
zwemmen	zw:e:m:m:e:n|zw:ɛ::m:ə:	76
zwempak	zw:e:m:p:a:k|zw:ɛ:m:p:ɑ:k	5
zwemt	zw:e:mt|zw:ɛ:mt	61
zwerm	zw:e:rm|zw:ɛ:rm	3
zwerver	zw:e:r:v:e:r|zw:ɛ:r:v:ə:r	4
zweten	zw:e::t:e:n|zw:eː::t:ə:	5
zweven	zw:e::v:e:n|zw:eː::v:ə:	7
zwiep	zw:ie:p|zw:iː:p	2
zwiept	zw:ie:pt|zw:iː:pt	10
zwieren	zw:ie::r:e:n|zw:iː::r:ə:	2
zwiert	zw:ie:rt|zw:iː:rt	12
zwijgt	zw:ij:gt|zw:ɛi:çt	7
zwijn	zw:ij:n|zw:ɛi:n	47
zwom	zw:o:m|zw:ɔ:m	3
