word	type match	token match
sojourn	sozieve	sojoups
blinded	flinded	glinded
poltergeist	poltergeast	polterlials
asians	aseens	aroons
atomizes	apomizes	atogizes
epilogue	epilomes	epiloped
denotative	denotatism	detotative
cheapens	choomens	steapens
unfeeling	unfeiling	unfeaving
recurrent	recursent	reconpent
changes	challes	challes
restructuring	restructoring	restrurtoring
haystack	hagstand	hapstack
chaplaincy	chaplainfy	whaplaincy
slackens	drackens	drornens
rumble	dumble	raxple
wile	wite	wigh
swallowing	snallowing	smallowing
abbreviation	absteviation	autheviation
speed	fleed	clead
grassiest	flassiest	grakeiest
brandish	brindish	thandish
oleaginous	oleucinous	oluetiries
outmarches	outmaultes	outmaultes
treacherous	stoocherous	trounderous
geographers	geognaphers	geocraphers
telstars	teltrars	telchars
brawls	clazed	bralms
dissociated	distoriated	densociated
accrue	acquah	acquab
peaty	reaty	pouty
ruction	duction	riction
interlinks	interlibes	interlinct
explicated	enplicated	estricated
insupportable	insoxportable	insurportable
blether	flether	flether
pillocks	pillones	pillogne
resolvable	resowlable	resoidable
behaviour	behocrour	behaymour
counteracts	counterales	counteraire
arraigns	arraoued	arralids
downright	dongright	dortright
plantain	plantail	flintain
profusion	prosusion	prososion
slog	slig	sleg
suspecting	suspenting	suspesting
rayon	ragon	rupon
rhapsodizing	whapsodizing	clausodizing
hebrews	hechews	hebrads
modules	moducts	modumed
collie	colloe	pattee
crisp	clusp	crewe
traumatically	tralsitically	scatratically
laundrymen	lasscrymen	luckbrymen
resigned	resiques	resights
inculcating	incitlating	incuccating
outmarching	outmaulting	outmaulting
concatenations	concitenations	convarenations
deuces	dieces	dieces
quickies	swickies	knoldies
mallards	mallates	mallings
antiseptics	antisaptics	antisyptics
midget	misset	mimpet
prosecutes	prosecotes	prosecines
overtrump	overtruan	overdlife
severed	movered	sevense
plucking	frecking	grucking
pullman	pideman	pulltan
evergreens	evertroons	everbreans
soutane	moutane	soutade
bigamous	bugamous	vegamous
vacuous	vapuous	bacuous
mapped	macked	marned
embroiling	embrilling	embrorsing
intercommunicate	intercommunicals	ilnoltungerising
fracturing	grurbaring	phacturing
phonological	phonocogical	sponological
protozoan	protojoan	protowoan
denomination	detomination	denelination
fights	finged	fipped
skeins	skiens	wrearn
insulators	insacators	inculators
primarily	priparily	pritarily
timing	faming	niming
revolves	revormed	nevolves
vertebrate	vertecrate	vertedrate
conjured	conpured	conjared
obduracy	osduracy	osduracy
elicit	elixit	emicit
porousness	polousness	popeasmals
ballets	callets	ballect
jurist	jusits	jurand
holland	hollack	hollans
cavalry	cavalty	celalry
webs	wesh	weff
counsellors	councullors	couttullors
admired	adnired	adjored
neap	noup	noup
malformed	malfolves	malfonged
frozen	frowen	crozen
