word	type match	token match
millwheels	minksheels	mindsleels
belligerent	lilligerent	belliferent
creoles	creorts	creoirs
napkins	napcins	naywins
bangs	bawed	banes
vulcanized	vulpanized	vowcaninct
fifty	fixty	firty
tailpiece	tailfiece	tardniece
coachbuilder	coardcoarder	coosebuilder
mousiness	moudiness	moosiness
principles	princitres	prinviples
thermion	theldion	thelfion
stipulation	stupulation	scetulation
myths	mymes	myres
filipinos	firipinos	filipisas
announces	anveartes	annountes
enmities	enminies	enlities
courgette	courbiced	courgerge
bacchanalian	baccranalian	bonchanigian
aneroid	anerold	aneroir
hulking	hurging	hussing
underbidding	undercopping	underdueling
shipping	shapping	fripping
dickering	deckering	direering
heftily	leftily	tudsily
abeyant	abexant	afocant
granulate	flanulate	whanulate
maisonettes	maisonesced	maisonesque
upset	udbet	upsey
whip	quap	whil
variegate	hariegate	nariegure
phials	knials	snials
namedropping	nartbropping	nackbropping
crisscrossing	crisschossing	crindchassing
analogy	apalogy	anilogy
potpourri	potmourri	podfourri
psychologies	psyplologies	psycholosies
tailored	taitored	noybends
haply	hasly	hatly
puncher	pincher	purster
roughhouses	rearthouses	routhhouses
feasible	feusible	feusible
preliminary	prelitinary	preliginary
precincts	precipsed	precights
clumped	crinked	clugged
tabs	taws	talm
casters	cathers	cachers
racetracks	ramestacks	rureplaste
selective	semactive	sevective
refuse	regend	refurt
tunnels	tennels	tunnert
hangdog	hartrog	haredog
expatiates	ennatiates	expatiasms
sobriety	sospiety	socriety
fizzing	figning	figning
regarded	refenced	repussed
pulses	pudees	puoyes
barman	carman	bunlin
raga	rada	naga
chancellor	chancullor	whancellor
scavenging	plavenging	friverging
potassium	polassium	pomassium
moneymaker	monegmaker	monegmager
morpheus	morsteus	morgleus
offshoot	ollspoot	owsproot
bulkiest	buskiest	buoyiest
fortification	firtification	fortinication
permanently	pertanently	pegnanently
closing	plusing	sposing
sidestep	sirestep	sishtrif
hoarding	heirding	heirding
minders	minkers	milders
dad	wid	lon
violent	wiolent	liolent
scaled	scaned	scarch
agency	agenny	agenny
backstage	laughingstoys	bandchage
guidebook	backtrage	goosebook
whalers	guicebook	spalers
infringements	snalers	inthingements
minks	inclengements	mirds
overcompensation	hores	overnonmagration
presciently	overcoptensation	prebliently
tutelage	pregliently	gutelage
communism	tutelays	communics
mugged	compunism	mumped
foal	holled	feap
rotogravure	feil	rotocrafure
holdings	rotogravums	hongings
ultramarine	hortings	ultramarize
liars	ultramarits	huant
hibernates	fiars	hiberlered
peahen	hibercates	peehen
check	reahen	chern
migraine	chens	migrazed
stylists	migrause	chepides
princes	stysists	priltes
immodesties	prirdes	immagesties
chesterfield	immadesties	chesterfiefs
