word	type match	token match
dishiest	distiest	dilliest
rosinned	rosirth	rosineguns
tomfooleries	tomseeleries	nomnuleries
iambics	iambage	iambise
honourable	tonourable	honearable
ghouls	schemps	srirts
possessiveness	possissiveness	poscessiveness
heedful	heepful	hoodful
hatched	hance	hamp
bridges	bradges	brimpes
console	consome	consosts
vapidity	vapicity	napidity
dustup	rustup	dustudes
audiometer	alsioseter	alsibifetor
parody	parogy	parosy
weightily	neightily	thullily
epicentres	epicenses	epicopses
fashions	tiloons	farkions
bearer	booter	bourer
indescribable	indedrizable	indechakable
nightmare	nightmam	nithmare
ailments	ainments	awments
sufferer	suggerer	sefferer
deskwork	dertwork	derdwork
randomly	randowly	randartly
grudges	gruces	pludges
blotted	flutted	throtted
benin	bebin	belin
pioneers	pionours	pionoons
obstructive	obtructive	obmuctive
teensy	feensy	toonsy
accept	accelt	accened
unsaying	unsorting	unsassing
transept	transelt	transened
attendant	astendant	attestant
rebuking	reburting	reburging
synonyms	synonyse	synonype
outmanoeuvred	outmanyrpred	outmanourred
homophones	homophore	homophond
banging	balling	bawing
prefer	chewer	gefer
plump	blale	plutched
inflictions	influctions	intlictions
disentangles	disentanfes	disentanses
pullets	mullel	pullered
allegations	impogations	allefations
default	defangued	defaths
philatelist	stilatelist	philatelum
burnishing	belcessing	burniping
medicals	meticals	medicay
therm	frarm	thelves
subtitle	subtidle	subtisphe
rod	suts	ped
epicure	epicose	epicere
virgos	virnos	vitchios
apparatus	ablaratus	allaratos
piers	piew	poors
asbestos	asmestos	asplestos
sender	moster	sester
vetoers	veloers	vecoers
histamine	histasals	histamone
mixing	mithing	mighing
hairbrush	hairhush	hairstrush
enfeebling	enfoobling	enceebling
fulsomeness	fulsordness	fulsockness
profanation	prowanation	proxanation
sweetbreads	sweetflade	sweetbrads
marvellously	manpellously	marpeslously
indian	ician	indiar
invoiced	invincts	invowl
autocrats	autobrats	autoscrides
capering	casering	calering
parricide	parricines	parricit
narrowness	ninagness	narrordness
interviewers	intervupers	interviecers
counteract	counterace	counterale
superstar	superpar	supersar
allopathic	allopafic	allopangic
apishly	apisly	apicly
journeyman	jeerneyman	frugnopman
tiebreak	teubrig	toebrau
sedateness	seduntness	sedangness
paw	pag	rong
pickled	radled	pightled
crystallization	stystallization	phystallization
malaya	malaka	malassa
tracks	jocks	traths
recant	recand	recare
homelands	hortlands	homedaid
carouses	calouses	capeases
exaggeratedly	exaggerately	arriguntastively
quadruply	quadluply	quadnuply
valuing	galuing	baluing
rooked	rool	rench
fins	fim	fimes
gyro	westo	gullo
banalities	tanalities	phonalities
adv	aif	auled
laurel	lawrel	lardrel
protoplasm	prototrasm	protozosm
